START SAY hi what school do you go to | SAY i am MY_SCHOOL MY_MAJOR SELECT NAME FRIEND_FULL_NAME	SAY MY_SCHOOL my major is MY_MAJOR MY_MAJOR | SELECT NAME FRIEND_FULL_NAME
START | SAY MY_SCHOOL my major is MY_MAJOR MY_MAJOR | SELECT NAME FRIEND_FULL_NAME	SAY hi what school do you go to | SAY i am MY_SCHOOL MY_MAJOR SELECT NAME FRIEND_FULL_NAME | PASS
START SAY hello friend SAY here is my list | SAY FRIEND_FULL_NAME SAY FRIEND_FULL_NAME | SAY FRIEND_FULL_NAME SAY FRIEND_FULL_NAME | SAY FRIEND_FULL_NAME SAY yes SELECT NAME FRIEND_FULL_NAME	SAY hi where do you go to school | SAY no FRIEND_FULL_NAME | SAY FRIEND_FULL_NAME SELECT NAME FRIEND_FULL_NAME | PASS
START | SAY hi where do you go to school | SAY no FRIEND_FULL_NAME | SAY FRIEND_FULL_NAME SELECT NAME FRIEND_FULL_NAME	SAY hello friend SAY here is my list | SAY FRIEND_FULL_NAME SAY FRIEND_FULL_NAME | SAY FRIEND_FULL_NAME SAY FRIEND_FULL_NAME | SAY FRIEND_FULL_NAME SAY yes SELECT NAME FRIEND_FULL_NAME
START SAY hi who do you work for | SAY MY_MAJOR | SAY do you know FRIEND_FULL_NAME | SAY i work for MY_COMPANY | SELECT NAME FRIEND_FULL_NAME	SAY MY_COMPANY SAY what is your major | SAY who do you work for | SAY no | SELECT NAME FRIEND_FULL_NAME | PASS
START | SAY MY_COMPANY SAY what is your major | SAY who do you work for | SAY no | SELECT NAME FRIEND_FULL_NAME	SAY hi who do you work for | SAY MY_MAJOR | SAY do you know FRIEND_FULL_NAME | SAY i work for MY_COMPANY | SELECT NAME FRIEND_FULL_NAME
START SAY hi what is your school | SAY yes SAY yours | SAY MY_SCHOOL of calif MY_SCHOOL | SELECT NAME FRIEND_FULL_NAME	SAY is your major MY_MAJOR | SAY i go to MY_SCHOOL SAY major is MY_MAJOR SAY what about you | SAY what company do you work for | SAY i work for MY_COMPANY SELECT NAME FRIEND_FULL_NAME
START | SAY is your major MY_MAJOR | SAY i go to MY_SCHOOL SAY major is MY_MAJOR SAY what about you | SAY what company do you work for | SAY i work for MY_COMPANY SELECT NAME FRIEND_FULL_NAME	SAY hi what is your school | SAY yes SAY yours | SAY MY_SCHOOL of calif MY_SCHOOL | SELECT NAME FRIEND_FULL_NAME | PASS
START SAY hi | SAY MY_SCHOOL SAY compscience | SAY FRIEND_FULL_NAME SELECT NAME FRIEND_FULL_NAME | SELECT NAME FRIEND_FULL_NAME	SAY MY_SCHOOL of MY_SCHOOL MY_SCHOOL SAY MY_MAJOR MY_MAJOR major SAY you | SAY name | SAY thats not it | SELECT NAME FRIEND_FULL_NAME
START | SAY MY_SCHOOL of MY_SCHOOL MY_SCHOOL SAY MY_MAJOR MY_MAJOR major SAY you | SAY name | SAY thats not it | SELECT NAME FRIEND_FULL_NAME	SAY hi | SAY MY_SCHOOL SAY compscience | SAY FRIEND_FULL_NAME SELECT NAME FRIEND_FULL_NAME | SELECT NAME FRIEND_FULL_NAME | PASS
START SAY hi what school do you go to | SAY MY_SCHOOL physicsapple here SAY do you know FRIEND_FULL_NAME hes at MY_COMPANY | SELECT NAME FRIEND_FULL_NAME	SAY hi MY_SCHOOL googlecs SAY yours | SAY FRIEND_FULL_NAME a name you recognized o SELECT NAME FRIEND_FULL_NAME SAY | PASS
START | SAY hi MY_SCHOOL googlecs SAY yours | SAY FRIEND_FULL_NAME a name you recognized o SELECT NAME FRIEND_FULL_NAME SAY	SAY hi what school do you go to | SAY MY_SCHOOL physicsapple here SAY do you know FRIEND_FULL_NAME hes at MY_COMPANY | SELECT NAME FRIEND_FULL_NAME
START SAY hello | SAY MY_SCHOOL MY_MAJOR MY_COMPANY you | SAY FRIEND_FULL_NAME | SELECT NAME FRIEND_FULL_NAME	SAY hi there | SAY MY_MAJOR berkely MY_COMPANY SAY do you have any fronds form MY_SCHOOL SAY from MY_COMPANY SAY friends | SAY yup | SELECT NAME FRIEND_FULL_NAME
START | SAY hi there | SAY MY_MAJOR berkely MY_COMPANY SAY do you have any fronds form MY_SCHOOL SAY from MY_COMPANY SAY friends | SAY yup | SELECT NAME FRIEND_FULL_NAME	SAY hello | SAY MY_SCHOOL MY_MAJOR MY_COMPANY you | SAY FRIEND_FULL_NAME | SELECT NAME FRIEND_FULL_NAME | PASS
START SAY bring on the virgins to wax my loins SAY sorry wrong room SAY MY_SCHOOL MY_MAJOR MY_COMPANY | SAY no SAY give me info SAY quickly SAY read the info at the top under your info | SAY FRIEND_FULL_NAME brunnette SAY FRIEND_FULL_NAME | SELECT NAME FRIEND_FULL_NAME	SAY do you have any MY_COMPANY | SAY MY_SCHOOL MY_MAJOR MY_COMPANY | SAY yes | SELECT NAME FRIEND_FULL_NAME
START | SAY do you have any MY_COMPANY | SAY MY_SCHOOL MY_MAJOR MY_COMPANY | SAY yes | SELECT NAME FRIEND_FULL_NAME	SAY bring on the virgins to wax my loins SAY sorry wrong room SAY MY_SCHOOL MY_MAJOR MY_COMPANY | SAY no SAY give me info SAY quickly SAY read the info at the top under your info | SAY FRIEND_FULL_NAME brunnette SAY FRIEND_FULL_NAME | SELECT NAME FRIEND_FULL_NAME | PASS
START SAY hi | SAY MY_SCHOOL MY_MAJOR MY_COMPANY SELECT NAME FRIEND_FULL_NAME	SAY MY_SCHOOL MY_MAJOR MY_COMPANY SAY hi | SELECT NAME FRIEND_FULL_NAME
START | SAY MY_SCHOOL MY_MAJOR MY_COMPANY SAY hi | SELECT NAME FRIEND_FULL_NAME	SAY hi | SAY MY_SCHOOL MY_MAJOR MY_COMPANY SELECT NAME FRIEND_FULL_NAME | PASS
START SAY hey what school do you go to | SAY do you know FRIEND_FULL_NAME | SAY do you work or MY_COMPANY or MY_COMPANY | SAY do you know FRIEND_FULL_NAME or a FRIEND_FULL_NAME | SELECT NAME FRIEND_FULL_NAME	SAY MY_SCHOOL | SAY no | SAY MY_COMPANY | SAY i know a FRIEND_FULL_NAME | SAY yes SELECT NAME FRIEND_FULL_NAME
START | SAY MY_SCHOOL | SAY no | SAY MY_COMPANY | SAY i know a FRIEND_FULL_NAME | SAY yes SELECT NAME FRIEND_FULL_NAME	SAY hey what school do you go to | SAY do you know FRIEND_FULL_NAME | SAY do you work or MY_COMPANY or MY_COMPANY | SAY do you know FRIEND_FULL_NAME or a FRIEND_FULL_NAME | SELECT NAME FRIEND_FULL_NAME | PASS
START SAY what company do you work for | SAY i dont know anyone at MY_COMPANY how about your major SAY MY_SCHOOL | SAY do you know FRIEND_FULL_NAME espirutu | SELECT NAME FRIEND_FULL_NAME	SAY MY_COMPANY SAY what school do you go to | SAY sorry i work for MY_COMPANY SAY i was confused | SAY i do | SELECT NAME FRIEND_FULL_NAME
START | SAY MY_COMPANY SAY what school do you go to | SAY sorry i work for MY_COMPANY SAY i was confused | SAY i do | SELECT NAME FRIEND_FULL_NAME	SAY what company do you work for | SAY i dont know anyone at MY_COMPANY how about your major SAY MY_SCHOOL | SAY do you know FRIEND_FULL_NAME espirutu | SELECT NAME FRIEND_FULL_NAME | PASS
START SELECT NAME FRIEND_FULL_NAME | SELECT NAME FRIEND_FULL_NAME | SAY no | SELECT NAME FRIEND_FULL_NAME | SELECT NAME FRIEND_FULL_NAME	SELECT NAME FRIEND_FULL_NAME | SELECT NAME FRIEND_FULL_NAME | SELECT NAME FRIEND_FULL_NAME | SELECT NAME FRIEND_FULL_NAME | PASS
START | SELECT NAME FRIEND_FULL_NAME | SELECT NAME FRIEND_FULL_NAME | SELECT NAME FRIEND_FULL_NAME | SELECT NAME FRIEND_FULL_NAME	SELECT NAME FRIEND_FULL_NAME | SELECT NAME FRIEND_FULL_NAME | SAY no | SELECT NAME FRIEND_FULL_NAME | SELECT NAME FRIEND_FULL_NAME
START SAY hello | SAY everyone here works at MY_COMPANY | SELECT NAME FRIEND_FULL_NAME	SAY hi everyone here works at MY_COMPANY | SELECT NAME FRIEND_FULL_NAME | PASS
START | SAY hi everyone here works at MY_COMPANY | SELECT NAME FRIEND_FULL_NAME	SAY hello | SAY everyone here works at MY_COMPANY | SELECT NAME FRIEND_FULL_NAME
START SAY hi there | SAY MY_SCHOOL MY_MAJOR MY_COMPANY here what about you | SAY do you have a friend named FRIEND_FULL_NAME | SAY woo | SELECT NAME FRIEND_FULL_NAME	SAY hey | SAY MY_SCHOOL MY_MAJOR MY_COMPANY | SAY yep | SAY nice | SELECT NAME FRIEND_FULL_NAME
START | SAY hey | SAY MY_SCHOOL MY_MAJOR MY_COMPANY | SAY yep | SAY nice | SELECT NAME FRIEND_FULL_NAME	SAY hi there | SAY MY_SCHOOL MY_MAJOR MY_COMPANY here what about you | SAY do you have a friend named FRIEND_FULL_NAME | SAY woo | SELECT NAME FRIEND_FULL_NAME | PASS
START SAY hi | SAY MY_SCHOOL | SAY major mine is MY_MAJOR MY_MAJOR | SELECT NAME FRIEND_FULL_NAME SAY MY_COMPANY	SAY howdy | SAY MY_SCHOOL | SAY same SAY company MY_COMPANY | SELECT NAME FRIEND_FULL_NAME
START | SAY howdy | SAY MY_SCHOOL | SAY same SAY company MY_COMPANY | SELECT NAME FRIEND_FULL_NAME	SAY hi | SAY MY_SCHOOL | SAY major mine is MY_MAJOR MY_MAJOR | SELECT NAME FRIEND_FULL_NAME SAY MY_COMPANY | PASS
START SAY hello do you know danyelle derose | SELECT NAME FRIEND_FULL_NAME	SAY yes | SELECT NAME FRIEND_FULL_NAME
START | SAY yes | SELECT NAME FRIEND_FULL_NAME	SAY hello do you know danyelle derose | SELECT NAME FRIEND_FULL_NAME | PASS
START SAY hello SAY u MY_SCHOOL MY_MAJOR MY_COMPANY | SAY if this is your first one we basically tell each other our details and match them up with the most likely person we both know | SAY interesting all mine are from MY_COMPANY SAY so which one is from MY_COMPANY on your list that would be the answer | SAY great thanks SELECT NAME FRIEND_FULL_NAME	SAY hi | SAY oh okay SAY i have one friend from MY_COMPANY all the rest are MY_COMPANY | SAY FRIEND_FULL_NAME SELECT NAME FRIEND_FULL_NAME | PASS
START | SAY hi | SAY oh okay SAY i have one friend from MY_COMPANY all the rest are MY_COMPANY | SAY FRIEND_FULL_NAME SELECT NAME FRIEND_FULL_NAME	SAY hello SAY u MY_SCHOOL MY_MAJOR MY_COMPANY | SAY if this is your first one we basically tell each other our details and match them up with the most likely person we both know | SAY interesting all mine are from MY_COMPANY SAY so which one is from MY_COMPANY on your list that would be the answer | SAY great thanks SELECT NAME FRIEND_FULL_NAME
START SAY MY_SCHOOL MY_MAJOR MY_COMPANY SAY i have one MY_COMPANY SAY everything else is MY_COMPANY | SAY derose | SELECT NAME FRIEND_FULL_NAME	SAY i have one MY_SCHOOL MY_MAJOR and all but one is MY_COMPANY | SAY FRIEND_FULL_NAME | SELECT NAME FRIEND_FULL_NAME
START | SAY i have one MY_SCHOOL MY_MAJOR and all but one is MY_COMPANY | SAY FRIEND_FULL_NAME | SELECT NAME FRIEND_FULL_NAME	SAY MY_SCHOOL MY_MAJOR MY_COMPANY SAY i have one MY_COMPANY SAY everything else is MY_COMPANY | SAY derose | SELECT NAME FRIEND_FULL_NAME | PASS
START SAY i have 1 friend from MY_COMPANY FRIEND_FULL_NAME SAY all others MY_COMPANY SAY you there | SAY FRIEND_FULL_NAME FRIEND_FULL_NAME FRIEND_FULL_NAME SAY SAY FRIEND_FULL_NAME or FRIEND_FULL_NAME | SELECT NAME FRIEND_FULL_NAME	SAY yes one from MY_COMPANY who is also university of pa | SAY FRIEND_FULL_NAME | SELECT NAME FRIEND_FULL_NAME
START | SAY yes one from MY_COMPANY who is also university of pa | SAY FRIEND_FULL_NAME | SELECT NAME FRIEND_FULL_NAME	SAY i have 1 friend from MY_COMPANY FRIEND_FULL_NAME SAY all others MY_COMPANY SAY you there | SAY FRIEND_FULL_NAME FRIEND_FULL_NAME FRIEND_FULL_NAME SAY SAY FRIEND_FULL_NAME or FRIEND_FULL_NAME | SELECT NAME FRIEND_FULL_NAME | PASS
START SAY hi there MY_SCHOOL MY_MAJOR MY_MAJOR MY_COMPANY how about you | SAY is FRIEND_FULL_NAME your friend | SAY mk what about FRIEND_FULL_NAME or FRIEND_FULL_NAME | SELECT NAME FRIEND_FULL_NAME	SAY MY_SCHOOL linquistics MY_COMPANY | SAY no | SAY FRIEND_FULL_NAME | SELECT NAME FRIEND_FULL_NAME
START | SAY MY_SCHOOL linquistics MY_COMPANY | SAY no | SAY FRIEND_FULL_NAME | SELECT NAME FRIEND_FULL_NAME	SAY hi there MY_SCHOOL MY_MAJOR MY_MAJOR MY_COMPANY how about you | SAY is FRIEND_FULL_NAME your friend | SAY mk what about FRIEND_FULL_NAME or FRIEND_FULL_NAME | SELECT NAME FRIEND_FULL_NAME | PASS
START SAY do you know FRIEND_FULL_NAME | SAY nope | SAY FRIEND_FULL_NAME | SELECT NAME FRIEND_FULL_NAME	SAY FRIEND_FULL_NAME FRIEND_FULL_NAME FRIEND_FULL_NAME FRIEND_FULL_NAME | SAY FRIEND_FULL_NAME FRIEND_FULL_NAME FRIEND_FULL_NAME FRIEND_FULL_NAME alinethanh | SELECT NAME FRIEND_FULL_NAME | PASS
START | SAY FRIEND_FULL_NAME FRIEND_FULL_NAME FRIEND_FULL_NAME FRIEND_FULL_NAME | SAY FRIEND_FULL_NAME FRIEND_FULL_NAME FRIEND_FULL_NAME FRIEND_FULL_NAME alinethanh | SELECT NAME FRIEND_FULL_NAME	SAY do you know FRIEND_FULL_NAME | SAY nope | SAY FRIEND_FULL_NAME | SELECT NAME FRIEND_FULL_NAME
START SAY hi | SAY no | SAY FRIEND_FULL_NAME FRIEND_FULL_NAME FRIEND_FULL_NAME FRIEND_FULL_NAME | SELECT NAME FRIEND_FULL_NAME	SAY FRIEND_FULL_NAME FRIEND_FULL_NAME nathaniel jonathan | SAY FRIEND_FULL_NAME FRIEND_FULL_NAME FRIEND_FULL_NAME any matches | SAY FRIEND_FULL_NAME SELECT NAME FRIEND_FULL_NAME | PASS
START | SAY FRIEND_FULL_NAME FRIEND_FULL_NAME nathaniel jonathan | SAY FRIEND_FULL_NAME FRIEND_FULL_NAME FRIEND_FULL_NAME any matches | SAY FRIEND_FULL_NAME SELECT NAME FRIEND_FULL_NAME	SAY hi | SAY no | SAY FRIEND_FULL_NAME FRIEND_FULL_NAME FRIEND_FULL_NAME FRIEND_FULL_NAME | SELECT NAME FRIEND_FULL_NAME
START SAY my info is upen MY_MAJOR MY_COMPANY what is yours its at top of screen | SAY FRIEND_FULL_NAME | SAY yes SELECT NAME FRIEND_FULL_NAME	SAY university of MY_SCHOOL MY_MAJOR MY_COMPANY you | SAY no FRIEND_FULL_NAME | SELECT NAME FRIEND_FULL_NAME
START | SAY university of MY_SCHOOL MY_MAJOR MY_COMPANY you | SAY no FRIEND_FULL_NAME | SELECT NAME FRIEND_FULL_NAME	SAY my info is upen MY_MAJOR MY_COMPANY what is yours its at top of screen | SAY FRIEND_FULL_NAME | SAY yes SELECT NAME FRIEND_FULL_NAME | PASS
START SAY hi | SAY berkley major MY_MAJOR here | SELECT NAME FRIEND_FULL_NAME | SAY MY_COMPANY SELECT NAME FRIEND_FULL_NAME | SELECT NAME FRIEND_FULL_NAME	SAY hi SAY your school SAY mine is MY_SCHOOL | SAY MY_MAJOR MY_COMPANY here | SELECT NAME FRIEND_FULL_NAME | SAY MY_SCHOOL MY_MAJOR MY_COMPANY SELECT NAME FRIEND_FULL_NAME | PASS
START | SAY hi SAY your school SAY mine is MY_SCHOOL | SAY MY_MAJOR MY_COMPANY here | SELECT NAME FRIEND_FULL_NAME | SAY MY_SCHOOL MY_MAJOR MY_COMPANY SELECT NAME FRIEND_FULL_NAME	SAY hi | SAY berkley major MY_MAJOR here | SELECT NAME FRIEND_FULL_NAME | SAY MY_COMPANY SELECT NAME FRIEND_FULL_NAME | SELECT NAME FRIEND_FULL_NAME
START SAY hi SAY MY_SCHOOL MY_MAJOR MY_COMPANY and you | SAY friday | SELECT NAME FRIEND_FULL_NAME	SAY hey there SAY tell me what you got SAY FRIEND_FULL_NAME SAY FRIEND_FULL_NAME SAY FRIEND_FULL_NAME SAY FRIEND_FULL_NAME SAY FRIEND_FULL_NAME | SAY FRIEND_FULL_NAME friday | SAY oops SAY FRIEND_FULL_NAME SELECT NAME FRIEND_FULL_NAME
START | SAY hey there SAY tell me what you got SAY FRIEND_FULL_NAME SAY FRIEND_FULL_NAME SAY FRIEND_FULL_NAME SAY FRIEND_FULL_NAME SAY FRIEND_FULL_NAME | SAY FRIEND_FULL_NAME friday | SAY oops SAY FRIEND_FULL_NAME SELECT NAME FRIEND_FULL_NAME	SAY hi SAY MY_SCHOOL MY_MAJOR MY_COMPANY and you | SAY friday | SELECT NAME FRIEND_FULL_NAME | PASS
START SAY hi what school do you go to | SAY MY_SCHOOL MY_MAJOR MY_COMPANY | SAY no SAY FRIEND_FULL_NAME | SAY no | SAY yes SELECT NAME FRIEND_FULL_NAME	SAY MY_SCHOOL MY_MAJOR MY_COMPANY SAY you | SAY FRIEND_FULL_NAME | SAY FRIEND_FULL_NAME SAY no | SAY dang SAY FRIEND_FULL_NAME | SELECT NAME FRIEND_FULL_NAME
START | SAY MY_SCHOOL MY_MAJOR MY_COMPANY SAY you | SAY FRIEND_FULL_NAME | SAY FRIEND_FULL_NAME SAY no | SAY dang SAY FRIEND_FULL_NAME | SELECT NAME FRIEND_FULL_NAME	SAY hi what school do you go to | SAY MY_SCHOOL MY_MAJOR MY_COMPANY | SAY no SAY FRIEND_FULL_NAME | SAY no | SAY yes SELECT NAME FRIEND_FULL_NAME | PASS
START SAY hello SAY FRIEND_FULL_NAME SAY zachary SAY FRIEND_FULL_NAME | SAY yes SELECT NAME FRIEND_FULL_NAME	SAY FRIEND_FULL_NAME SELECT NAME FRIEND_FULL_NAME | PASS
START | SAY FRIEND_FULL_NAME SELECT NAME FRIEND_FULL_NAME	SAY hello SAY FRIEND_FULL_NAME SAY zachary SAY FRIEND_FULL_NAME | SAY yes SELECT NAME FRIEND_FULL_NAME
START SAY FRIEND_FULL_NAME FRIEND_FULL_NAME FRIEND_FULL_NAME FRIEND_FULL_NAME FRIEND_FULL_NAME | SELECT NAME FRIEND_FULL_NAME	SAY do you know a lollia FRIEND_FULL_NAME FRIEND_FULL_NAME or FRIEND_FULL_NAME | SELECT NAME FRIEND_FULL_NAME
START | SAY do you know a lollia FRIEND_FULL_NAME FRIEND_FULL_NAME or FRIEND_FULL_NAME | SELECT NAME FRIEND_FULL_NAME	SAY FRIEND_FULL_NAME FRIEND_FULL_NAME FRIEND_FULL_NAME FRIEND_FULL_NAME FRIEND_FULL_NAME | SELECT NAME FRIEND_FULL_NAME | PASS
START SAY hi there MY_SCHOOL MY_MAJOR MY_COMPANY for me what about you | SAY all MY_COMPANY one MY_COMPANY SAY whats your apples name | SAY k shes on mine SELECT NAME FRIEND_FULL_NAME	SAY i have one MY_COMPANY all others are MY_COMPANY u | SAY FRIEND_FULL_NAME | SELECT NAME FRIEND_FULL_NAME
START | SAY i have one MY_COMPANY all others are MY_COMPANY u | SAY FRIEND_FULL_NAME | SELECT NAME FRIEND_FULL_NAME	SAY hi there MY_SCHOOL MY_MAJOR MY_COMPANY for me what about you | SAY all MY_COMPANY one MY_COMPANY SAY whats your apples name | SAY k shes on mine SELECT NAME FRIEND_FULL_NAME | PASS
START SAY hi | SAY do you have friends that work for MY_COMPANY | SAY no SAY piggott | SAY gapinski SAY i have no MY_COMPANY | SELECT NAME FRIEND_FULL_NAME	SAY lots of stanfords | SAY FRIEND_FULL_NAME | SAY MY_COMPANY FRIEND_FULL_NAME SAY no piggott | SAY yes SELECT NAME FRIEND_FULL_NAME | PASS
START | SAY lots of stanfords | SAY FRIEND_FULL_NAME | SAY MY_COMPANY FRIEND_FULL_NAME SAY no piggott | SAY yes SELECT NAME FRIEND_FULL_NAME	SAY hi | SAY do you have friends that work for MY_COMPANY | SAY no SAY piggott | SAY gapinski SAY i have no MY_COMPANY | SELECT NAME FRIEND_FULL_NAME
START SAY whats your major | SAY university of californiaberk SELECT NAME FRIEND_FULL_NAME	SAY hi who do you work for SAY MY_MAJOR | SELECT NAME FRIEND_FULL_NAME
START | SAY hi who do you work for SAY MY_MAJOR | SELECT NAME FRIEND_FULL_NAME	SAY whats your major | SAY university of californiaberk SELECT NAME FRIEND_FULL_NAME | PASS
START SAY hello SAY hello SAY FRIEND_FULL_NAME SAY FRIEND_FULL_NAME FRIEND_FULL_NAME FRIEND_FULL_NAME | SAY none of those for me | SAY FRIEND_FULL_NAME SAY FRIEND_FULL_NAME | SELECT NAME FRIEND_FULL_NAME | SAY yep	SAY hello SAY FRIEND_FULL_NAME FRIEND_FULL_NAME FRIEND_FULL_NAME FRIEND_FULL_NAME FRIEND_FULL_NAME SAY | SAY FRIEND_FULL_NAME FRIEND_FULL_NAME FRIEND_FULL_NAME FRIEND_FULL_NAME FRIEND_FULL_NAME | SAY nope | SAY FRIEND_FULL_NAME | SELECT NAME FRIEND_FULL_NAME
START | SAY hello SAY FRIEND_FULL_NAME FRIEND_FULL_NAME FRIEND_FULL_NAME FRIEND_FULL_NAME FRIEND_FULL_NAME SAY | SAY FRIEND_FULL_NAME FRIEND_FULL_NAME FRIEND_FULL_NAME FRIEND_FULL_NAME FRIEND_FULL_NAME | SAY nope | SAY FRIEND_FULL_NAME | SELECT NAME FRIEND_FULL_NAME	SAY hello SAY hello SAY FRIEND_FULL_NAME SAY FRIEND_FULL_NAME FRIEND_FULL_NAME FRIEND_FULL_NAME | SAY none of those for me | SAY FRIEND_FULL_NAME SAY FRIEND_FULL_NAME | SELECT NAME FRIEND_FULL_NAME | SAY yep | PASS
START SAY all friends are MY_COMPANY workers | SAY majors jessica SELECT NAME FRIEND_FULL_NAME	SAY jeisca seaton or FRIEND_FULL_NAME | SELECT NAME FRIEND_FULL_NAME
START | SAY jeisca seaton or FRIEND_FULL_NAME | SELECT NAME FRIEND_FULL_NAME	SAY all friends are MY_COMPANY workers | SAY majors jessica SELECT NAME FRIEND_FULL_NAME | PASS
START SAY hello | SAY all MY_COMPANY | SAY who is your MY_COMPANY friend | SELECT NAME FRIEND_FULL_NAME	SAY hi SAY ive got all MY_COMPANY one MY_COMPANY | SAY one MY_MAJOR major one MY_MAJOR major SAY one MY_MAJOR | SAY FRIEND_FULL_NAME | SELECT NAME FRIEND_FULL_NAME
START | SAY hi SAY ive got all MY_COMPANY one MY_COMPANY | SAY one MY_MAJOR major one MY_MAJOR major SAY one MY_MAJOR | SAY FRIEND_FULL_NAME | SELECT NAME FRIEND_FULL_NAME	SAY hello | SAY all MY_COMPANY | SAY who is your MY_COMPANY friend | SELECT NAME FRIEND_FULL_NAME | PASS
START SAY my school is MY_SCHOOL major is MY_MAJOR and company i work for is MY_COMPANY you | SELECT NAME FRIEND_FULL_NAME	SAY berkley MY_MAJOR MY_MAJOR MY_COMPANY | SELECT NAME FRIEND_FULL_NAME
START | SAY berkley MY_MAJOR MY_MAJOR MY_COMPANY | SELECT NAME FRIEND_FULL_NAME	SAY my school is MY_SCHOOL major is MY_MAJOR and company i work for is MY_COMPANY you | SELECT NAME FRIEND_FULL_NAME | PASS
START SAY hello | SAY do you know from MY_SCHOOL who | SAY is that the only one if so how about MY_SCHOOL | SAY nope and nope | SAY nope do you know any of these FRIEND_FULL_NAME SAY FRIEND_FULL_NAME | SAY leeena hensel SELECT NAME FRIEND_FULL_NAME	SAY hello | SAY FRIEND_FULL_NAME | SAY FRIEND_FULL_NAME and FRIEND_FULL_NAME | SAY MY_SCHOOL is SAY FRIEND_FULL_NAME SAY FRIEND_FULL_NAME SAY FRIEND_FULL_NAME | SAY yes FRIEND_FULL_NAME SELECT NAME FRIEND_FULL_NAME | PASS
START | SAY hello | SAY FRIEND_FULL_NAME | SAY FRIEND_FULL_NAME and FRIEND_FULL_NAME | SAY MY_SCHOOL is SAY FRIEND_FULL_NAME SAY FRIEND_FULL_NAME SAY FRIEND_FULL_NAME | SAY yes FRIEND_FULL_NAME SELECT NAME FRIEND_FULL_NAME	SAY hello | SAY do you know from MY_SCHOOL who | SAY is that the only one if so how about MY_SCHOOL | SAY nope and nope | SAY nope do you know any of these FRIEND_FULL_NAME SAY FRIEND_FULL_NAME | SAY leeena hensel SELECT NAME FRIEND_FULL_NAME
START SAY hi there MY_SCHOOL MY_MAJOR MY_COMPANY you | SAY is FRIEND_FULL_NAME your friend | SAY yup SELECT NAME FRIEND_FULL_NAME	SAY MY_SCHOOL MY_MAJOR MY_COMPANY | SAY yes yours too | SELECT NAME FRIEND_FULL_NAME
START | SAY MY_SCHOOL MY_MAJOR MY_COMPANY | SAY yes yours too | SELECT NAME FRIEND_FULL_NAME	SAY hi there MY_SCHOOL MY_MAJOR MY_COMPANY you | SAY is FRIEND_FULL_NAME your friend | SAY yup SELECT NAME FRIEND_FULL_NAME | PASS
START SAY asl im a doctor in mexico and moderate an important forum that do anything for you SAY stanfrd MY_MAJOR MY_COMPANY SAY whats your info its at top of screen | SAY FRIEND_FULL_NAME SELECT NAME FRIEND_FULL_NAME	SAY all mine are MY_COMPANY | SELECT NAME FRIEND_FULL_NAME
START | SAY all mine are MY_COMPANY | SELECT NAME FRIEND_FULL_NAME	SAY asl im a doctor in mexico and moderate an important forum that do anything for you SAY stanfrd MY_MAJOR MY_COMPANY SAY whats your info its at top of screen | SAY FRIEND_FULL_NAME SELECT NAME FRIEND_FULL_NAME | PASS
START SELECT NAME FRIEND_FULL_NAME | SELECT NAME FRIEND_FULL_NAME | SELECT NAME FRIEND_FULL_NAME | SELECT NAME FRIEND_FULL_NAME	SAY i have 2 from MY_COMPANY one from MY_COMPANY rest are from MY_COMPANY | SAY where do your friends work | SELECT NAME FRIEND_FULL_NAME | PASS
START | SAY i have 2 from MY_COMPANY one from MY_COMPANY rest are from MY_COMPANY | SAY where do your friends work | SELECT NAME FRIEND_FULL_NAME	SELECT NAME FRIEND_FULL_NAME | SELECT NAME FRIEND_FULL_NAME | SELECT NAME FRIEND_FULL_NAME | SELECT NAME FRIEND_FULL_NAME
START SAY i have 1 MY_COMPANY 1 MY_COMPANY all others are MY_COMPANY | SAY FRIEND_FULL_NAME | SELECT NAME FRIEND_FULL_NAME	SAY FRIEND_FULL_NAME FRIEND_FULL_NAME FRIEND_FULL_NAME SAY MY_COMPANY | SAY no FRIEND_FULL_NAME SAY yes FRIEND_FULL_NAME sorry SELECT NAME FRIEND_FULL_NAME | PASS
START | SAY FRIEND_FULL_NAME FRIEND_FULL_NAME FRIEND_FULL_NAME SAY MY_COMPANY | SAY no FRIEND_FULL_NAME SAY yes FRIEND_FULL_NAME sorry SELECT NAME FRIEND_FULL_NAME	SAY i have 1 MY_COMPANY 1 MY_COMPANY all others are MY_COMPANY | SAY FRIEND_FULL_NAME | SELECT NAME FRIEND_FULL_NAME
START SAY are you a breakfast food | SAY no SAY FRIEND_FULL_NAME | SAY FRIEND_FULL_NAME | SAY FRIEND_FULL_NAME FRIEND_FULL_NAME FRIEND_FULL_NAME FRIEND_FULL_NAME | SAY FRIEND_FULL_NAME SELECT NAME FRIEND_FULL_NAME	SAY FRIEND_FULL_NAME | SAY samuell tatum SAY no | SAY FRIEND_FULL_NAME FRIEND_FULL_NAME or FRIEND_FULL_NAME SAY no | SAY FRIEND_FULL_NAME FRIEND_FULL_NAME FRIEND_FULL_NAME FRIEND_FULL_NAME FRIEND_FULL_NAME | SELECT NAME FRIEND_FULL_NAME
START | SAY FRIEND_FULL_NAME | SAY samuell tatum SAY no | SAY FRIEND_FULL_NAME FRIEND_FULL_NAME or FRIEND_FULL_NAME SAY no | SAY FRIEND_FULL_NAME FRIEND_FULL_NAME FRIEND_FULL_NAME FRIEND_FULL_NAME FRIEND_FULL_NAME | SELECT NAME FRIEND_FULL_NAME	SAY are you a breakfast food | SAY no SAY FRIEND_FULL_NAME | SAY FRIEND_FULL_NAME | SAY FRIEND_FULL_NAME FRIEND_FULL_NAME FRIEND_FULL_NAME FRIEND_FULL_NAME | SAY FRIEND_FULL_NAME SELECT NAME FRIEND_FULL_NAME | PASS
START SAY FRIEND_FULL_NAME FRIEND_FULL_NAME FRIEND_FULL_NAME FRIEND_FULL_NAME FRIEND_FULL_NAME nathaniel | SELECT NAME FRIEND_FULL_NAME	SELECT NAME FRIEND_FULL_NAME | PASS
START | SELECT NAME FRIEND_FULL_NAME	SAY FRIEND_FULL_NAME FRIEND_FULL_NAME FRIEND_FULL_NAME FRIEND_FULL_NAME FRIEND_FULL_NAME nathaniel | SELECT NAME FRIEND_FULL_NAME
START SAY hello | SAY yes 2 | SAY 3 from colubia one from university of pa SELECT NAME FRIEND_FULL_NAME	SAY hi SAY any of your friends from MY_SCHOOL | SAY majoring in MY_MAJOR or MY_MAJOR | SELECT NAME FRIEND_FULL_NAME
START | SAY hi SAY any of your friends from MY_SCHOOL | SAY majoring in MY_MAJOR or MY_MAJOR | SELECT NAME FRIEND_FULL_NAME	SAY hello | SAY yes 2 | SAY 3 from colubia one from university of pa SELECT NAME FRIEND_FULL_NAME | PASS
START SAY what school did you go to | SAY i went to MY_SCHOOL SAY whats your major and company | SAY majored in MY_MAJOR and work for MY_COMPANY | SAY i cant find you on my list SAY yes | SELECT NAME FRIEND_FULL_NAME SELECT NAME FRIEND_FULL_NAME	SAY i went to MY_SCHOOL you | SAY i majored in MY_MAJOR and work for MY_COMPANY yourself | SAY are you friends with FRIEND_FULL_NAME | SELECT NAME FRIEND_FULL_NAME SAY me too | PASS
START | SAY i went to MY_SCHOOL you | SAY i majored in MY_MAJOR and work for MY_COMPANY yourself | SAY are you friends with FRIEND_FULL_NAME | SELECT NAME FRIEND_FULL_NAME SAY me too	SAY what school did you go to | SAY i went to MY_SCHOOL SAY whats your major and company | SAY majored in MY_MAJOR and work for MY_COMPANY | SAY i cant find you on my list SAY yes | SELECT NAME FRIEND_FULL_NAME SELECT NAME FRIEND_FULL_NAME
START SAY ive got all MY_COMPANY SAY one MY_SCHOOL | SAY no two sorry SAY yep SELECT NAME FRIEND_FULL_NAME	SAY FRIEND_FULL_NAME | SELECT NAME FRIEND_FULL_NAME
START | SAY FRIEND_FULL_NAME | SELECT NAME FRIEND_FULL_NAME	SAY ive got all MY_COMPANY SAY one MY_SCHOOL | SAY no two sorry SAY yep SELECT NAME FRIEND_FULL_NAME | PASS
START SAY my school is MY_SCHOOL major is MY_MAJOR and company is MY_COMPANY you | SELECT NAME FRIEND_FULL_NAME	SAY hi MY_SCHOOL MY_MAJOR MY_COMPANY SELECT NAME FRIEND_FULL_NAME | PASS
START | SAY hi MY_SCHOOL MY_MAJOR MY_COMPANY SELECT NAME FRIEND_FULL_NAME	SAY my school is MY_SCHOOL major is MY_MAJOR and company is MY_COMPANY you | SELECT NAME FRIEND_FULL_NAME
START SAY hello | SAY only one MY_COMPANY friend FRIEND_FULL_NAME | SAY no | SAY FRIEND_FULL_NAME tysonkamfletcherjosh | SELECT NAME FRIEND_FULL_NAME	SAY hi where did you go to school | SAY no but i do work at MY_COMPANY SAY do you know FRIEND_FULL_NAME | SAY i went to u MY_SCHOOL and majored in MY_MAJOR | SAY oh shoot i do have a tamarasorry SELECT NAME FRIEND_FULL_NAME | PASS
START | SAY hi where did you go to school | SAY no but i do work at MY_COMPANY SAY do you know FRIEND_FULL_NAME | SAY i went to u MY_SCHOOL and majored in MY_MAJOR | SAY oh shoot i do have a tamarasorry SELECT NAME FRIEND_FULL_NAME	SAY hello | SAY only one MY_COMPANY friend FRIEND_FULL_NAME | SAY no | SAY FRIEND_FULL_NAME tysonkamfletcherjosh | SELECT NAME FRIEND_FULL_NAME
START SAY hi | SAY none of my friends went to berkley | SAY FRIEND_FULL_NAME SAY FRIEND_FULL_NAME FRIEND_FULL_NAME FRIEND_FULL_NAME | SAY yes SELECT NAME FRIEND_FULL_NAME | SAY select FRIEND_FULL_NAME from the list and well get our completion cod	SAY hello | SAY ok | SAY FRIEND_FULL_NAME | SAY ok | SELECT NAME FRIEND_FULL_NAME
START | SAY hello | SAY ok | SAY FRIEND_FULL_NAME | SAY ok | SELECT NAME FRIEND_FULL_NAME	SAY hi | SAY none of my friends went to berkley | SAY FRIEND_FULL_NAME SAY FRIEND_FULL_NAME FRIEND_FULL_NAME FRIEND_FULL_NAME | SAY yes SELECT NAME FRIEND_FULL_NAME | SAY select FRIEND_FULL_NAME from the list and well get our completion cod | PASS
START SAY is the person FRIEND_FULL_NAME SAY FRIEND_FULL_NAME SAY FRIEND_FULL_NAME SAY FRIEND_FULL_NAME | SAY nope SAY FRIEND_FULL_NAME SAY FRIEND_FULL_NAME | SAY standford | SAY nope SAY FRIEND_FULL_NAME | SELECT NAME FRIEND_FULL_NAME	SELECT NAME FRIEND_FULL_NAME | SAY where did they go to school | SAY FRIEND_FULL_NAME | SAY yes | SELECT NAME FRIEND_FULL_NAME
START | SELECT NAME FRIEND_FULL_NAME | SAY where did they go to school | SAY FRIEND_FULL_NAME | SAY yes | SELECT NAME FRIEND_FULL_NAME	SAY is the person FRIEND_FULL_NAME SAY FRIEND_FULL_NAME SAY FRIEND_FULL_NAME SAY FRIEND_FULL_NAME | SAY nope SAY FRIEND_FULL_NAME SAY FRIEND_FULL_NAME | SAY standford | SAY nope SAY FRIEND_FULL_NAME | SELECT NAME FRIEND_FULL_NAME | PASS
START SELECT NAME FRIEND_FULL_NAME | SAY MY_SCHOOL | SELECT NAME FRIEND_FULL_NAME SELECT NAME FRIEND_FULL_NAME | SAY FRIEND_FULL_NAME FRIEND_FULL_NAME any of this you have SELECT NAME FRIEND_FULL_NAME | SELECT NAME FRIEND_FULL_NAME	SAY what school did you go to | SELECT NAME FRIEND_FULL_NAME | SAY major SELECT NAME FRIEND_FULL_NAME | SAY i have FRIEND_FULL_NAME | PASS
START | SAY what school did you go to | SELECT NAME FRIEND_FULL_NAME | SAY major SELECT NAME FRIEND_FULL_NAME | SAY i have FRIEND_FULL_NAME	SELECT NAME FRIEND_FULL_NAME | SAY MY_SCHOOL | SELECT NAME FRIEND_FULL_NAME SELECT NAME FRIEND_FULL_NAME | SAY FRIEND_FULL_NAME FRIEND_FULL_NAME any of this you have SELECT NAME FRIEND_FULL_NAME | SELECT NAME FRIEND_FULL_NAME
START SAY everyone works at MY_COMPANY | SELECT NAME FRIEND_FULL_NAME	SELECT NAME FRIEND_FULL_NAME | PASS
START | SELECT NAME FRIEND_FULL_NAME	SAY everyone works at MY_COMPANY | SELECT NAME FRIEND_FULL_NAME
START SAY all friends are MY_COMPANY but one SAY FRIEND_FULL_NAME | SAY yes FRIEND_FULL_NAME | SELECT NAME FRIEND_FULL_NAME	SAY i only have one fb rest are MY_COMPANY SAY FRIEND_FULL_NAME | SELECT NAME FRIEND_FULL_NAME | PASS
START | SAY i only have one fb rest are MY_COMPANY SAY FRIEND_FULL_NAME | SELECT NAME FRIEND_FULL_NAME	SAY all friends are MY_COMPANY but one SAY FRIEND_FULL_NAME | SAY yes FRIEND_FULL_NAME | SELECT NAME FRIEND_FULL_NAME
START SAY hi | SAY i go to MY_SCHOOL | SAY whats your school SAY im with MY_COMPANY | SAY do you know anyone named FRIEND_FULL_NAME | SAY FRIEND_FULL_NAME | SELECT NAME FRIEND_FULL_NAME	SAY hi SAY i am from MY_COMPANY | SAY ok | SAY MY_SCHOOL of pennsylva SAY what is your friend SAY mutually | SELECT NAME FRIEND_FULL_NAME SAY no | SELECT NAME FRIEND_FULL_NAME | PASS
START | SAY hi SAY i am from MY_COMPANY | SAY ok | SAY MY_SCHOOL of pennsylva SAY what is your friend SAY mutually | SELECT NAME FRIEND_FULL_NAME SAY no | SELECT NAME FRIEND_FULL_NAME	SAY hi | SAY i go to MY_SCHOOL | SAY whats your school SAY im with MY_COMPANY | SAY do you know anyone named FRIEND_FULL_NAME | SAY FRIEND_FULL_NAME | SELECT NAME FRIEND_FULL_NAME
START SAY hello | SAY upenn MY_MAJOR MY_MAJOR and MY_COMPANY | SAY yep | SELECT NAME FRIEND_FULL_NAME	SAY im uc MY_SCHOOL MY_MAJOR MY_COMPANY SAY u | SAY FRIEND_FULL_NAME | SELECT NAME FRIEND_FULL_NAME | PASS
START | SAY im uc MY_SCHOOL MY_MAJOR MY_COMPANY SAY u | SAY FRIEND_FULL_NAME | SELECT NAME FRIEND_FULL_NAME	SAY hello | SAY upenn MY_MAJOR MY_MAJOR and MY_COMPANY | SAY yep | SELECT NAME FRIEND_FULL_NAME
START SAY hi | SELECT NAME FRIEND_FULL_NAME | SELECT NAME FRIEND_FULL_NAME SAY collin SELECT NAME FRIEND_FULL_NAME	SAY hi MY_SCHOOL mathapple | SAY x | SELECT NAME FRIEND_FULL_NAME
START | SAY hi MY_SCHOOL mathapple | SAY x | SELECT NAME FRIEND_FULL_NAME	SAY hi | SELECT NAME FRIEND_FULL_NAME | SELECT NAME FRIEND_FULL_NAME SAY collin SELECT NAME FRIEND_FULL_NAME | PASS
START SAY one MY_COMPANY all others are MY_COMPANY SAY sorry not MY_COMPANY its MY_COMPANY | SAY FRIEND_FULL_NAME FRIEND_FULL_NAME FRIEND_FULL_NAME any SAY FRIEND_FULL_NAME FRIEND_FULL_NAME | SAY no | SELECT NAME FRIEND_FULL_NAME	SELECT NAME FRIEND_FULL_NAME | SAY no FRIEND_FULL_NAME | SAY jessica | SELECT NAME FRIEND_FULL_NAME
START | SELECT NAME FRIEND_FULL_NAME | SAY no FRIEND_FULL_NAME | SAY jessica | SELECT NAME FRIEND_FULL_NAME	SAY one MY_COMPANY all others are MY_COMPANY SAY sorry not MY_COMPANY its MY_COMPANY | SAY FRIEND_FULL_NAME FRIEND_FULL_NAME FRIEND_FULL_NAME any SAY FRIEND_FULL_NAME FRIEND_FULL_NAME | SAY no | SELECT NAME FRIEND_FULL_NAME | PASS
START SAY MY_SCHOOL MY_MAJOR MY_COMPANY | SAY i have no MY_COMPANY and one MY_COMPANY SAY sharman | SELECT NAME FRIEND_FULL_NAME	SAY i have all MY_COMPANY and one MY_COMPANY | SAY FRIEND_FULL_NAME | SELECT NAME FRIEND_FULL_NAME
START | SAY i have all MY_COMPANY and one MY_COMPANY | SAY FRIEND_FULL_NAME | SELECT NAME FRIEND_FULL_NAME	SAY MY_SCHOOL MY_MAJOR MY_COMPANY | SAY i have no MY_COMPANY and one MY_COMPANY SAY sharman | SELECT NAME FRIEND_FULL_NAME | PASS
START SAY hi SAY any friends work for MY_COMPANY | SAY FRIEND_FULL_NAME SELECT NAME FRIEND_FULL_NAME	SAY FRIEND_FULL_NAME FRIEND_FULL_NAME FRIEND_FULL_NAME FRIEND_FULL_NAME FRIEND_FULL_NAME SAY any first name match | SAY FRIEND_FULL_NAME details SELECT NAME FRIEND_FULL_NAME
START | SAY FRIEND_FULL_NAME FRIEND_FULL_NAME FRIEND_FULL_NAME FRIEND_FULL_NAME FRIEND_FULL_NAME SAY any first name match | SAY FRIEND_FULL_NAME details SELECT NAME FRIEND_FULL_NAME	SAY hi SAY any friends work for MY_COMPANY | SAY FRIEND_FULL_NAME SELECT NAME FRIEND_FULL_NAME | PASS
START SAY hi do you know FRIEND_FULL_NAME only one i have at MY_COMPANY | SAY FRIEND_FULL_NAME SELECT NAME FRIEND_FULL_NAME	SAY sadly no SAY do you know FRIEND_FULL_NAME FRIEND_FULL_NAME | SELECT NAME FRIEND_FULL_NAME
START | SAY sadly no SAY do you know FRIEND_FULL_NAME FRIEND_FULL_NAME | SELECT NAME FRIEND_FULL_NAME	SAY hi do you know FRIEND_FULL_NAME only one i have at MY_COMPANY | SAY FRIEND_FULL_NAME SELECT NAME FRIEND_FULL_NAME | PASS
START SAY hi | SAY FRIEND_FULL_NAME FRIEND_FULL_NAME FRIEND_FULL_NAME FRIEND_FULL_NAME | SAY FRIEND_FULL_NAME FRIEND_FULL_NAME FRIEND_FULL_NAME no to lilla | SAY FRIEND_FULL_NAME FRIEND_FULL_NAME FRIEND_FULL_NAME SELECT NAME FRIEND_FULL_NAME	SAY hello | SAY is lilla mikel on your list | SELECT NAME FRIEND_FULL_NAME | PASS
START | SAY hello | SAY is lilla mikel on your list | SELECT NAME FRIEND_FULL_NAME	SAY hi | SAY FRIEND_FULL_NAME FRIEND_FULL_NAME FRIEND_FULL_NAME FRIEND_FULL_NAME | SAY FRIEND_FULL_NAME FRIEND_FULL_NAME FRIEND_FULL_NAME no to lilla | SAY FRIEND_FULL_NAME FRIEND_FULL_NAME FRIEND_FULL_NAME SELECT NAME FRIEND_FULL_NAME
START SAY hello SAY my info is MY_SCHOOL MY_MAJOR MY_COMPANY | SAY whats your info we should be able to find some possible candidates | SAY neither of those oare on mine | SAY yep SELECT NAME FRIEND_FULL_NAME	SAY hi | SAY i have uc MY_SCHOOL upenn MY_SCHOOL SAY i have two MY_MAJOR SAY FRIEND_FULL_NAME and FRIEND_FULL_NAME | SAY ok i have one MY_COMPANY SAY FRIEND_FULL_NAME | SELECT NAME FRIEND_FULL_NAME
START | SAY hi | SAY i have uc MY_SCHOOL upenn MY_SCHOOL SAY i have two MY_MAJOR SAY FRIEND_FULL_NAME and FRIEND_FULL_NAME | SAY ok i have one MY_COMPANY SAY FRIEND_FULL_NAME | SELECT NAME FRIEND_FULL_NAME	SAY hello SAY my info is MY_SCHOOL MY_MAJOR MY_COMPANY | SAY whats your info we should be able to find some possible candidates | SAY neither of those oare on mine | SAY yep SELECT NAME FRIEND_FULL_NAME | PASS
START SAY MY_SCHOOL major is MY_MAJOR SAY you SAY hello SAY company is MY_COMPANY SAY MY_SCHOOL major is MY_MAJOR SAY company is MY_COMPANY SAY you | SELECT NAME FRIEND_FULL_NAME	SAY MY_SCHOOL MY_SCHOOL MY_COMPANY SAY MY_MAJOR major | SELECT NAME FRIEND_FULL_NAME
START | SAY MY_SCHOOL MY_SCHOOL MY_COMPANY SAY MY_MAJOR major | SELECT NAME FRIEND_FULL_NAME	SAY MY_SCHOOL major is MY_MAJOR SAY you SAY hello SAY company is MY_COMPANY SAY MY_SCHOOL major is MY_MAJOR SAY company is MY_COMPANY SAY you | SELECT NAME FRIEND_FULL_NAME | PASS
START SAY hey im standford MY_MAJOR MY_MAJOR MY_COMPANY | SAY yep SELECT NAME FRIEND_FULL_NAME	SAY only one MY_COMPANY friend FRIEND_FULL_NAME | SELECT NAME FRIEND_FULL_NAME
START | SAY only one MY_COMPANY friend FRIEND_FULL_NAME | SELECT NAME FRIEND_FULL_NAME	SAY hey im standford MY_MAJOR MY_MAJOR MY_COMPANY | SAY yep SELECT NAME FRIEND_FULL_NAME | PASS
START SAY FRIEND_FULL_NAME FRIEND_FULL_NAME FRIEND_FULL_NAME FRIEND_FULL_NAME FRIEND_FULL_NAME | SELECT NAME FRIEND_FULL_NAME	SAY MY_SCHOOL MY_MAJOR MY_COMPANY SAY one MY_COMPANY | SELECT NAME FRIEND_FULL_NAME
START | SAY MY_SCHOOL MY_MAJOR MY_COMPANY SAY one MY_COMPANY | SELECT NAME FRIEND_FULL_NAME	SAY FRIEND_FULL_NAME FRIEND_FULL_NAME FRIEND_FULL_NAME FRIEND_FULL_NAME FRIEND_FULL_NAME | SELECT NAME FRIEND_FULL_NAME | PASS
START SELECT NAME FRIEND_FULL_NAME | SAY ah our mutual friend	SELECT NAME FRIEND_FULL_NAME | SELECT NAME FRIEND_FULL_NAME
START | SELECT NAME FRIEND_FULL_NAME | SELECT NAME FRIEND_FULL_NAME	SELECT NAME FRIEND_FULL_NAME | SAY ah our mutual friend | PASS
START SAY hello | SAY MY_SCHOOL MY_MAJOR MY_COMPANY | SAY nope | SAY FRIEND_FULL_NAME | SAY FRIEND_FULL_NAME | SELECT NAME FRIEND_FULL_NAME	SAY my info school MY_SCHOOL berkley major MY_MAJOR comapny MY_COMPANY SAY whats your info hi | SELECT NAME FRIEND_FULL_NAME | SAY dang | SAY no | SELECT NAME FRIEND_FULL_NAME SAY nice | PASS
START | SAY my info school MY_SCHOOL berkley major MY_MAJOR comapny MY_COMPANY SAY whats your info hi | SELECT NAME FRIEND_FULL_NAME | SAY dang | SAY no | SELECT NAME FRIEND_FULL_NAME SAY nice	SAY hello | SAY MY_SCHOOL MY_MAJOR MY_COMPANY | SAY nope | SAY FRIEND_FULL_NAME | SAY FRIEND_FULL_NAME | SELECT NAME FRIEND_FULL_NAME
START SAY upenn MY_MAJOR MY_COMPANY what is your info SAY upenn MY_MAJOR MY_COMPANY SAY what is your info SAY its at top right corner | SAY do you have FRIEND_FULL_NAME SAY or FRIEND_FULL_NAME | SELECT NAME FRIEND_FULL_NAME	SAY MY_SCHOOL MY_MAJOR MY_COMPANY | SAY yup FRIEND_FULL_NAME | SELECT NAME FRIEND_FULL_NAME
START | SAY MY_SCHOOL MY_MAJOR MY_COMPANY | SAY yup FRIEND_FULL_NAME | SELECT NAME FRIEND_FULL_NAME	SAY upenn MY_MAJOR MY_COMPANY what is your info SAY upenn MY_MAJOR MY_COMPANY SAY what is your info SAY its at top right corner | SAY do you have FRIEND_FULL_NAME SAY or FRIEND_FULL_NAME | SELECT NAME FRIEND_FULL_NAME | PASS
START SAY what company do you work for | SAY MY_COMPANY and MY_SCHOOL | SELECT NAME FRIEND_FULL_NAME	SAY what company and school you work for | SAY is you FRIEND_FULL_NAME | SELECT NAME FRIEND_FULL_NAME
START | SAY what company and school you work for | SAY is you FRIEND_FULL_NAME | SELECT NAME FRIEND_FULL_NAME	SAY what company do you work for | SAY MY_COMPANY and MY_SCHOOL | SELECT NAME FRIEND_FULL_NAME | PASS
START SAY hello MY_SCHOOL csgoooog | SAY x | SAY xx | SAY xxx | SAY MY_SCHOOL | SELECT NAME FRIEND_FULL_NAME	SELECT NAME FRIEND_FULL_NAME | SELECT NAME FRIEND_FULL_NAME | SELECT NAME FRIEND_FULL_NAME | SAY what school do you go to SAY i go to MY_SCHOOL | SELECT NAME FRIEND_FULL_NAME | PASS
START | SELECT NAME FRIEND_FULL_NAME | SELECT NAME FRIEND_FULL_NAME | SELECT NAME FRIEND_FULL_NAME | SAY what school do you go to SAY i go to MY_SCHOOL | SELECT NAME FRIEND_FULL_NAME	SAY hello MY_SCHOOL csgoooog | SAY x | SAY xx | SAY xxx | SAY MY_SCHOOL | SELECT NAME FRIEND_FULL_NAME
START SAY FRIEND_FULL_NAME | SELECT NAME FRIEND_FULL_NAME SAY FRIEND_FULL_NAME FRIEND_FULL_NAME sheila FRIEND_FULL_NAME FRIEND_FULL_NAME | SELECT NAME FRIEND_FULL_NAME	SELECT NAME FRIEND_FULL_NAME | SELECT NAME FRIEND_FULL_NAME | PASS
START | SELECT NAME FRIEND_FULL_NAME | SELECT NAME FRIEND_FULL_NAME	SAY FRIEND_FULL_NAME | SELECT NAME FRIEND_FULL_NAME SAY FRIEND_FULL_NAME FRIEND_FULL_NAME sheila FRIEND_FULL_NAME FRIEND_FULL_NAME | SELECT NAME FRIEND_FULL_NAME
START SAY hey you there | SAY seems we hav a friend in common | SAY i got no one from MY_SCHOOL SAY MY_SCHOOL | SAY does their name begin with a d | SAY n | SAY no i mean the persons name SAY we have to cross reference SAY i have 5 people from standford SAY none from MY_SCHOOL SAY so it has to be someone from standford | SAY no SAY anyone named FRIEND_FULL_NAME | SAY FRIEND_FULL_NAME | SAY thats it SAY thats our winner | SELECT NAME FRIEND_FULL_NAME	SAY yep | SAY someone from MY_SCHOOL | SAY yes SAY i think SAY hahah | SAY no | SAY MY_SCHOOL SAY there is an n MY_SCHOOL SAY FRIEND_FULL_NAME | SAY start with an l | SAY no | SAY i have someone named FRIEND_FULL_NAME from MY_SCHOOL SAY but thats it | SELECT NAME FRIEND_FULL_NAME | PASS
START | SAY yep | SAY someone from MY_SCHOOL | SAY yes SAY i think SAY hahah | SAY no | SAY MY_SCHOOL SAY there is an n MY_SCHOOL SAY FRIEND_FULL_NAME | SAY start with an l | SAY no | SAY i have someone named FRIEND_FULL_NAME from MY_SCHOOL SAY but thats it | SELECT NAME FRIEND_FULL_NAME	SAY hey you there | SAY seems we hav a friend in common | SAY i got no one from MY_SCHOOL SAY MY_SCHOOL | SAY does their name begin with a d | SAY n | SAY no i mean the persons name SAY we have to cross reference SAY i have 5 people from standford SAY none from MY_SCHOOL SAY so it has to be someone from standford | SAY no SAY anyone named FRIEND_FULL_NAME | SAY FRIEND_FULL_NAME | SAY thats it SAY thats our winner | SELECT NAME FRIEND_FULL_NAME
START SAY hi all works at MY_COMPANY except 1 at MY_COMPANY | SELECT NAME FRIEND_FULL_NAME	SAY all work at MY_COMPANY except 1 at MY_COMPANY SAY FRIEND_FULL_NAME | SELECT NAME FRIEND_FULL_NAME
START | SAY all work at MY_COMPANY except 1 at MY_COMPANY SAY FRIEND_FULL_NAME | SELECT NAME FRIEND_FULL_NAME	SAY hi all works at MY_COMPANY except 1 at MY_COMPANY | SELECT NAME FRIEND_FULL_NAME | PASS
START SAY hi | SAY no fb for me just all MY_COMPANY and one MY_COMPANY | SAY FRIEND_FULL_NAME h yes SELECT NAME FRIEND_FULL_NAME	SAY hi SAY only one MY_COMPANY lorraine | SAY FRIEND_FULL_NAME or FRIEND_FULL_NAME | SELECT NAME FRIEND_FULL_NAME
START | SAY hi SAY only one MY_COMPANY lorraine | SAY FRIEND_FULL_NAME or FRIEND_FULL_NAME | SELECT NAME FRIEND_FULL_NAME	SAY hi | SAY no fb for me just all MY_COMPANY and one MY_COMPANY | SAY FRIEND_FULL_NAME h yes SELECT NAME FRIEND_FULL_NAME | PASS
START SAY lots of MY_SCHOOL SAY any MY_COMPANY | SAY MY_COMPANY | SAY no | SAY FRIEND_FULL_NAME | SAY FRIEND_FULL_NAME | SELECT NAME FRIEND_FULL_NAME	SAY no | SELECT NAME FRIEND_FULL_NAME | SAY lots of MY_COMPANY | SAY no | SELECT NAME FRIEND_FULL_NAME | PASS
START | SAY no | SELECT NAME FRIEND_FULL_NAME | SAY lots of MY_COMPANY | SAY no | SELECT NAME FRIEND_FULL_NAME	SAY lots of MY_SCHOOL SAY any MY_COMPANY | SAY MY_COMPANY | SAY no | SAY FRIEND_FULL_NAME | SAY FRIEND_FULL_NAME | SELECT NAME FRIEND_FULL_NAME
START SAY my friends are mostly MY_COMPANY SAY except FRIEND_FULL_NAME | SELECT NAME FRIEND_FULL_NAME	SAY most my friends work at MY_COMPANY | SAY yes SELECT NAME FRIEND_FULL_NAME
START | SAY most my friends work at MY_COMPANY | SAY yes SELECT NAME FRIEND_FULL_NAME	SAY my friends are mostly MY_COMPANY SAY except FRIEND_FULL_NAME | SELECT NAME FRIEND_FULL_NAME | PASS
START SAY hey | SAY FRIEND_FULL_NAME | SELECT NAME FRIEND_FULL_NAME	SAY hi all at MY_COMPANY except 1 at MY_COMPANY | SELECT NAME FRIEND_FULL_NAME | PASS
START | SAY hi all at MY_COMPANY except 1 at MY_COMPANY | SELECT NAME FRIEND_FULL_NAME	SAY hey | SAY FRIEND_FULL_NAME | SELECT NAME FRIEND_FULL_NAME
START SAY hey | SAY i am lorraine hulber from MY_SCHOOL my major is MY_MAJOR and my company is MY_COMPANY SAY whats your most popular school | SAY i havent anyone from there | SAY its all mostly MY_SCHOOL and 2 stanfard | SAY its FRIEND_FULL_NAME | SELECT NAME FRIEND_FULL_NAME	SAY hello | SAY MY_SCHOOL | SAY i got FRIEND_FULL_NAME from standford | SAY FRIEND_FULL_NAME hofmesiter colubmia | SAY FRIEND_FULL_NAME colubia | SELECT NAME FRIEND_FULL_NAME
START | SAY hello | SAY MY_SCHOOL | SAY i got FRIEND_FULL_NAME from standford | SAY FRIEND_FULL_NAME hofmesiter colubmia | SAY FRIEND_FULL_NAME colubia | SELECT NAME FRIEND_FULL_NAME	SAY hey | SAY i am lorraine hulber from MY_SCHOOL my major is MY_MAJOR and my company is MY_COMPANY SAY whats your most popular school | SAY i havent anyone from there | SAY its all mostly MY_SCHOOL and 2 stanfard | SAY its FRIEND_FULL_NAME | SELECT NAME FRIEND_FULL_NAME | PASS
START SAY most of my friends work at MY_COMPANY one works at MY_COMPANY and one at MY_COMPANY SAY are you there | SAY where do your friends work | SAY all of them | SAY do you have any that work at MY_COMPANY | SAY and MY_COMPANY | SAY okay then our mutual is FRIEND_FULL_NAME | SELECT NAME FRIEND_FULL_NAME	SAY yes | SAY MY_COMPANY | SAY not all | SAY no | SAY no | SELECT NAME FRIEND_FULL_NAME | PASS
START | SAY yes | SAY MY_COMPANY | SAY not all | SAY no | SAY no | SELECT NAME FRIEND_FULL_NAME	SAY most of my friends work at MY_COMPANY one works at MY_COMPANY and one at MY_COMPANY SAY are you there | SAY where do your friends work | SAY all of them | SAY do you have any that work at MY_COMPANY | SAY and MY_COMPANY | SAY okay then our mutual is FRIEND_FULL_NAME | SELECT NAME FRIEND_FULL_NAME
START SAY 2 MY_COMPANY rest is MY_COMPANY SAY u | SAY no SAY FRIEND_FULL_NAME bateman any SAY FRIEND_FULL_NAME FRIEND_FULL_NAME FRIEND_FULL_NAME | SELECT NAME FRIEND_FULL_NAME	SAY what is school and company SAY is u FRIEND_FULL_NAME | SAY you name | SELECT NAME FRIEND_FULL_NAME
START | SAY what is school and company SAY is u FRIEND_FULL_NAME | SAY you name | SELECT NAME FRIEND_FULL_NAME	SAY 2 MY_COMPANY rest is MY_COMPANY SAY u | SAY no SAY FRIEND_FULL_NAME bateman any SAY FRIEND_FULL_NAME FRIEND_FULL_NAME FRIEND_FULL_NAME | SELECT NAME FRIEND_FULL_NAME | PASS
START SELECT NAME FRIEND_FULL_NAME | SAY MY_SCHOOL MY_MAJOR MY_COMPANY | SELECT NAME FRIEND_FULL_NAME	SAY hi berkley MY_MAJOR MY_COMPANY | SELECT NAME FRIEND_FULL_NAME | SELECT NAME FRIEND_FULL_NAME
START | SAY hi berkley MY_MAJOR MY_COMPANY | SELECT NAME FRIEND_FULL_NAME | SELECT NAME FRIEND_FULL_NAME	SELECT NAME FRIEND_FULL_NAME | SAY MY_SCHOOL MY_MAJOR MY_COMPANY | SELECT NAME FRIEND_FULL_NAME | PASS
START SAY hiya | SAY all friends work at goole except 1 at MY_COMPANY FRIEND_FULL_NAME SELECT NAME FRIEND_FULL_NAME	SELECT NAME FRIEND_FULL_NAME | PASS
START | SELECT NAME FRIEND_FULL_NAME	SAY hiya | SAY all friends work at goole except 1 at MY_COMPANY FRIEND_FULL_NAME SELECT NAME FRIEND_FULL_NAME
START SAY hello i am a standford MY_MAJOR major who works at MY_COMPANY SAY do you know FRIEND_FULL_NAME | SELECT NAME FRIEND_FULL_NAME	SELECT NAME FRIEND_FULL_NAME | PASS
START | SELECT NAME FRIEND_FULL_NAME	SAY hello i am a standford MY_MAJOR major who works at MY_COMPANY SAY do you know FRIEND_FULL_NAME | SELECT NAME FRIEND_FULL_NAME
START SAY hi whats your major SAY mine is MY_MAJOR | SAY do you know FRIEND_FULL_NAME | SAY no SAY im at MY_SCHOOL what is your school | SAY FRIEND_FULL_NAME SELECT NAME FRIEND_FULL_NAME	SAY MY_MAJOR | SAY i dont do you know FRIEND_FULL_NAME | SAY what about FRIEND_FULL_NAME or FRIEND_FULL_NAME im at unviersity of MY_SCHOOL | SELECT NAME FRIEND_FULL_NAME
START | SAY MY_MAJOR | SAY i dont do you know FRIEND_FULL_NAME | SAY what about FRIEND_FULL_NAME or FRIEND_FULL_NAME im at unviersity of MY_SCHOOL | SELECT NAME FRIEND_FULL_NAME	SAY hi whats your major SAY mine is MY_MAJOR | SAY do you know FRIEND_FULL_NAME | SAY no SAY im at MY_SCHOOL what is your school | SAY FRIEND_FULL_NAME SELECT NAME FRIEND_FULL_NAME | PASS
START SAY hi any matches | SAY FRIEND_FULL_NAME FRIEND_FULL_NAME FRIEND_FULL_NAME | SAY no | SAY yes SELECT NAME FRIEND_FULL_NAME	SAY hi | SAY only one MY_COMPANY FRIEND_FULL_NAME | SAY FRIEND_FULL_NAME | SELECT NAME FRIEND_FULL_NAME
START | SAY hi | SAY only one MY_COMPANY FRIEND_FULL_NAME | SAY FRIEND_FULL_NAME | SELECT NAME FRIEND_FULL_NAME	SAY hi any matches | SAY FRIEND_FULL_NAME FRIEND_FULL_NAME FRIEND_FULL_NAME | SAY no | SAY yes SELECT NAME FRIEND_FULL_NAME | PASS
START SAY hi all at MY_COMPANY except 1 at MY_COMPANY | SELECT NAME FRIEND_FULL_NAME	SAY oilver SAY FRIEND_FULL_NAME | SELECT NAME FRIEND_FULL_NAME
START | SAY oilver SAY FRIEND_FULL_NAME | SELECT NAME FRIEND_FULL_NAME	SAY hi all at MY_COMPANY except 1 at MY_COMPANY | SELECT NAME FRIEND_FULL_NAME | PASS
START SAY hi | SAY all MY_COMPANY ppl for me | SAY FRIEND_FULL_NAME SELECT NAME FRIEND_FULL_NAME	SAY hi | SAY i have a lot of facebooks and two googles SAY ok SAY FRIEND_FULL_NAME or FRIEND_FULL_NAME | SELECT NAME FRIEND_FULL_NAME
START | SAY hi | SAY i have a lot of facebooks and two googles SAY ok SAY FRIEND_FULL_NAME or FRIEND_FULL_NAME | SELECT NAME FRIEND_FULL_NAME	SAY hi | SAY all MY_COMPANY ppl for me | SAY FRIEND_FULL_NAME SELECT NAME FRIEND_FULL_NAME | PASS
START SAY hi what is your school | SAY MY_SCHOOL SAY major | SAY mine linquistics | SELECT NAME FRIEND_FULL_NAME	SAY MY_SCHOOL SAY what is yours | SAY MY_MAJOR | SAY your company | SELECT NAME FRIEND_FULL_NAME
START | SAY MY_SCHOOL SAY what is yours | SAY MY_MAJOR | SAY your company | SELECT NAME FRIEND_FULL_NAME	SAY hi what is your school | SAY MY_SCHOOL SAY major | SAY mine linquistics | SELECT NAME FRIEND_FULL_NAME | PASS
START SAY mine all work for MY_COMPANY | SAY yep SELECT NAME FRIEND_FULL_NAME	SAY FRIEND_FULL_NAME is the only one i have that works for MY_COMPANY | SELECT NAME FRIEND_FULL_NAME
START | SAY FRIEND_FULL_NAME is the only one i have that works for MY_COMPANY | SELECT NAME FRIEND_FULL_NAME	SAY mine all work for MY_COMPANY | SAY yep SELECT NAME FRIEND_FULL_NAME | PASS
START SAY all MY_COMPANY SAY my friends are all from MY_COMPANY | SELECT NAME FRIEND_FULL_NAME	SAY FRIEND_FULL_NAME | SELECT NAME FRIEND_FULL_NAME
START | SAY FRIEND_FULL_NAME | SELECT NAME FRIEND_FULL_NAME	SAY all MY_COMPANY SAY my friends are all from MY_COMPANY | SELECT NAME FRIEND_FULL_NAME | PASS
START SAY hi | SAY FRIEND_FULL_NAME | SAY what school do you have in the top right | SAY ive got all MY_COMPANY one MY_COMPANY for companies | SELECT NAME FRIEND_FULL_NAME	SAY hi SAY most MY_COMPANY one MY_COMPANY and one MY_COMPANY | SAY no | SAY penns | SAY FRIEND_FULL_NAME SAY FRIEND_FULL_NAME | SELECT NAME FRIEND_FULL_NAME
START | SAY hi SAY most MY_COMPANY one MY_COMPANY and one MY_COMPANY | SAY no | SAY penns | SAY FRIEND_FULL_NAME SAY FRIEND_FULL_NAME | SELECT NAME FRIEND_FULL_NAME	SAY hi | SAY FRIEND_FULL_NAME | SAY what school do you have in the top right | SAY ive got all MY_COMPANY one MY_COMPANY for companies | SELECT NAME FRIEND_FULL_NAME | PASS
START SAY do you have friends who went to MY_SCHOOL | SAY okay i know two MY_COMPANY people SAY FRIEND_FULL_NAME | SELECT NAME FRIEND_FULL_NAME	SAY everyones MY_COMPANY two maths 1 MY_MAJOR MY_MAJOR SAY i have FRIEND_FULL_NAME FRIEND_FULL_NAME FRIEND_FULL_NAME from MY_SCHOOL | SELECT NAME FRIEND_FULL_NAME | PASS
START | SAY everyones MY_COMPANY two maths 1 MY_MAJOR MY_MAJOR SAY i have FRIEND_FULL_NAME FRIEND_FULL_NAME FRIEND_FULL_NAME from MY_SCHOOL | SELECT NAME FRIEND_FULL_NAME	SAY do you have friends who went to MY_SCHOOL | SAY okay i know two MY_COMPANY people SAY FRIEND_FULL_NAME | SELECT NAME FRIEND_FULL_NAME
START SAY hi | SAY all friends go to MY_SCHOOL but two go to MY_SCHOOL and upenn | SAY its FRIEND_FULL_NAME | SELECT NAME FRIEND_FULL_NAME	SAY one from MY_COMPANY FRIEND_FULL_NAME SAY one from MY_SCHOOL FRIEND_FULL_NAME | SAY one from MY_SCHOOL FRIEND_FULL_NAME | SELECT NAME FRIEND_FULL_NAME | PASS
START | SAY one from MY_COMPANY FRIEND_FULL_NAME SAY one from MY_SCHOOL FRIEND_FULL_NAME | SAY one from MY_SCHOOL FRIEND_FULL_NAME | SELECT NAME FRIEND_FULL_NAME	SAY hi | SAY all friends go to MY_SCHOOL but two go to MY_SCHOOL and upenn | SAY its FRIEND_FULL_NAME | SELECT NAME FRIEND_FULL_NAME
START SAY all company friends MY_COMPANY and two apples | SAY francinealine at MY_COMPANY SAY got it | SELECT NAME FRIEND_FULL_NAME	SAY all rigth i type all the names | SAY FRIEND_FULL_NAME | SAY FRIEND_FULL_NAME SELECT NAME FRIEND_FULL_NAME
START | SAY all rigth i type all the names | SAY FRIEND_FULL_NAME | SAY FRIEND_FULL_NAME SELECT NAME FRIEND_FULL_NAME	SAY all company friends MY_COMPANY and two apples | SAY francinealine at MY_COMPANY SAY got it | SELECT NAME FRIEND_FULL_NAME | PASS
START SAY hi | SAY FRIEND_FULL_NAME MY_SCHOOL MY_MAJOR MY_COMPANY SELECT NAME FRIEND_FULL_NAME | SAY yes SELECT NAME FRIEND_FULL_NAME	SAY hey SAY im MY_SCHOOL MY_MAJOR and MY_COMPANY | SAY do you know FRIEND_FULL_NAME | SELECT NAME FRIEND_FULL_NAME
START | SAY hey SAY im MY_SCHOOL MY_MAJOR and MY_COMPANY | SAY do you know FRIEND_FULL_NAME | SELECT NAME FRIEND_FULL_NAME	SAY hi | SAY FRIEND_FULL_NAME MY_SCHOOL MY_MAJOR MY_COMPANY SELECT NAME FRIEND_FULL_NAME | SAY yes SELECT NAME FRIEND_FULL_NAME | PASS
START SAY i go to upenn how about you | SAY im a MY_MAJOR major and my company is MY_COMPANY you | SELECT NAME FRIEND_FULL_NAME	SAY MY_SCHOOL SELECT NAME FRIEND_FULL_NAME | SAY MY_MAJOR MY_COMPANY | SELECT NAME FRIEND_FULL_NAME
START | SAY MY_SCHOOL SELECT NAME FRIEND_FULL_NAME | SAY MY_MAJOR MY_COMPANY | SELECT NAME FRIEND_FULL_NAME	SAY i go to upenn how about you | SAY im a MY_MAJOR major and my company is MY_COMPANY you | SELECT NAME FRIEND_FULL_NAME | PASS
START SAY hello SAY hi SAY i work at MY_COMPANY SAY i go to school at berkelye SAY and my major is MY_MAJOR | SAY the MY_COMPANY one | SELECT NAME FRIEND_FULL_NAME	SAY i have all MY_COMPANY plus one fb one MY_COMPANY | SAY thanks SELECT NAME FRIEND_FULL_NAME | PASS
START | SAY i have all MY_COMPANY plus one fb one MY_COMPANY | SAY thanks SELECT NAME FRIEND_FULL_NAME	SAY hello SAY hi SAY i work at MY_COMPANY SAY i go to school at berkelye SAY and my major is MY_MAJOR | SAY the MY_COMPANY one | SELECT NAME FRIEND_FULL_NAME
START SAY hi SAY fletch sher FRIEND_FULL_NAME joh lash | SAY FRIEND_FULL_NAME ren FRIEND_FULL_NAME FRIEND_FULL_NAME sam SELECT NAME FRIEND_FULL_NAME	SAY MY_MAJOR MY_MAJOR MY_COMPANY | SELECT NAME FRIEND_FULL_NAME
START | SAY MY_MAJOR MY_MAJOR MY_COMPANY | SELECT NAME FRIEND_FULL_NAME	SAY hi SAY fletch sher FRIEND_FULL_NAME joh lash | SAY FRIEND_FULL_NAME ren FRIEND_FULL_NAME FRIEND_FULL_NAME sam SELECT NAME FRIEND_FULL_NAME | PASS
START SAY hello SAY where did you go to school | SAY do you have FRIEND_FULL_NAME or FRIEND_FULL_NAME | SAY i went to MY_SCHOOL SELECT NAME FRIEND_FULL_NAME	SAY hi SAY MY_SCHOOL MY_SCHOOL berkley SAY you | SAY FRIEND_FULL_NAME | SELECT NAME FRIEND_FULL_NAME
START | SAY hi SAY MY_SCHOOL MY_SCHOOL berkley SAY you | SAY FRIEND_FULL_NAME | SELECT NAME FRIEND_FULL_NAME	SAY hello SAY where did you go to school | SAY do you have FRIEND_FULL_NAME or FRIEND_FULL_NAME | SAY i went to MY_SCHOOL SELECT NAME FRIEND_FULL_NAME | PASS
START SAY hi | SAY nope | SAY nope | SAY yes SAY FRIEND_FULL_NAME SELECT NAME FRIEND_FULL_NAME	SAY hi SAY FRIEND_FULL_NAME SAY FRIEND_FULL_NAME | SAY FRIEND_FULL_NAME SAY FRIEND_FULL_NAME | SAY FRIEND_FULL_NAME SAY FRIEND_FULL_NAME SAY FRIEND_FULL_NAME | SAY thanks SELECT NAME FRIEND_FULL_NAME
START | SAY hi SAY FRIEND_FULL_NAME SAY FRIEND_FULL_NAME | SAY FRIEND_FULL_NAME SAY FRIEND_FULL_NAME | SAY FRIEND_FULL_NAME SAY FRIEND_FULL_NAME SAY FRIEND_FULL_NAME | SAY thanks SELECT NAME FRIEND_FULL_NAME	SAY hi | SAY nope | SAY nope | SAY yes SAY FRIEND_FULL_NAME SELECT NAME FRIEND_FULL_NAME | PASS
START SAY hey SAY all fb people for me | SAY anyone work at MY_COMPANY on your list SAY mines FRIEND_FULL_NAME | SAY yes FRIEND_FULL_NAME SELECT NAME FRIEND_FULL_NAME	SAY hi your name please | SAY yep SAY FRIEND_FULL_NAME | SELECT NAME FRIEND_FULL_NAME
START | SAY hi your name please | SAY yep SAY FRIEND_FULL_NAME | SELECT NAME FRIEND_FULL_NAME	SAY hey SAY all fb people for me | SAY anyone work at MY_COMPANY on your list SAY mines FRIEND_FULL_NAME | SAY yes FRIEND_FULL_NAME SELECT NAME FRIEND_FULL_NAME | PASS
START SAY calf exo MY_COMPANY | SELECT NAME FRIEND_FULL_NAME	SAY FRIEND_FULL_NAME | SELECT NAME FRIEND_FULL_NAME
START | SAY FRIEND_FULL_NAME | SELECT NAME FRIEND_FULL_NAME	SAY calf exo MY_COMPANY | SELECT NAME FRIEND_FULL_NAME | PASS
START SAY MY_SCHOOL MY_MAJOR MY_COMPANY | SAY your information | SELECT NAME FRIEND_FULL_NAME	SAY what | SAY oh MY_SCHOOL MY_MAJOR MY_COMPANY | SELECT NAME FRIEND_FULL_NAME
START | SAY what | SAY oh MY_SCHOOL MY_MAJOR MY_COMPANY | SELECT NAME FRIEND_FULL_NAME	SAY MY_SCHOOL MY_MAJOR MY_COMPANY | SAY your information | SELECT NAME FRIEND_FULL_NAME | PASS
START SAY two MY_COMPANY rest MY_COMPANY | SAY FRIEND_FULL_NAME or FRIEND_FULL_NAME | SAY those are the only two i have who work at MY_COMPANY SAY they both went to standord SAY MY_SCHOOL | SELECT NAME FRIEND_FULL_NAME	SAY all my friends work at MY_COMPANY only one at MY_COMPANY | SAY i dont see either of those SAY where did your MY_COMPANY friends go to school | SAY oooh i see FRIEND_FULL_NAME now SAY my bad | SELECT NAME FRIEND_FULL_NAME
START | SAY all my friends work at MY_COMPANY only one at MY_COMPANY | SAY i dont see either of those SAY where did your MY_COMPANY friends go to school | SAY oooh i see FRIEND_FULL_NAME now SAY my bad | SELECT NAME FRIEND_FULL_NAME	SAY two MY_COMPANY rest MY_COMPANY | SAY FRIEND_FULL_NAME or FRIEND_FULL_NAME | SAY those are the only two i have who work at MY_COMPANY SAY they both went to standord SAY MY_SCHOOL | SELECT NAME FRIEND_FULL_NAME | PASS
START SAY hey SAY MY_COMPANY SAY who do you work for | SAY no MY_COMPANY SAY what do you do SAY FRIEND_FULL_NAME | SAY yes | SELECT NAME FRIEND_FULL_NAME	SAY MY_SCHOOL SAY work for MY_COMPANY | SELECT NAME FRIEND_FULL_NAME | SAY yes | PASS
START | SAY MY_SCHOOL SAY work for MY_COMPANY | SELECT NAME FRIEND_FULL_NAME | SAY yes	SAY hey SAY MY_COMPANY SAY who do you work for | SAY no MY_COMPANY SAY what do you do SAY FRIEND_FULL_NAME | SAY yes | SELECT NAME FRIEND_FULL_NAME
START SAY MY_SCHOOL MY_SCHOOL u of MY_SCHOOL | SAY FRIEND_FULL_NAME FRIEND_FULL_NAME | SAY all MY_COMPANY SAY one MY_COMPANY SAY MY_SCHOOL or u of MY_SCHOOL | SAY no | SAY yes | SELECT NAME FRIEND_FULL_NAME	SAY u of c berley | SAY no SAY MY_COMPANY or faceboo SAY MY_COMPANY | SAY FRIEND_FULL_NAME | SAY FRIEND_FULL_NAME | SAY bingo | SELECT NAME FRIEND_FULL_NAME
START | SAY u of c berley | SAY no SAY MY_COMPANY or faceboo SAY MY_COMPANY | SAY FRIEND_FULL_NAME | SAY FRIEND_FULL_NAME | SAY bingo | SELECT NAME FRIEND_FULL_NAME	SAY MY_SCHOOL MY_SCHOOL u of MY_SCHOOL | SAY FRIEND_FULL_NAME FRIEND_FULL_NAME | SAY all MY_COMPANY SAY one MY_COMPANY SAY MY_SCHOOL or u of MY_SCHOOL | SAY no | SAY yes | SELECT NAME FRIEND_FULL_NAME | PASS
START SAY everyone i know works at MY_COMPANY SAY you | SAY yup i know her SELECT NAME FRIEND_FULL_NAME	SAY FRIEND_FULL_NAME SAY only person i know at MY_COMPANY | SELECT NAME FRIEND_FULL_NAME
START | SAY FRIEND_FULL_NAME SAY only person i know at MY_COMPANY | SELECT NAME FRIEND_FULL_NAME	SAY everyone i know works at MY_COMPANY SAY you | SAY yup i know her SELECT NAME FRIEND_FULL_NAME | PASS
START SAY im MY_SCHOOL MY_MAJOR MY_COMPANY SAY whats your school major and company | SAY do you know FRIEND_FULL_NAME | SELECT NAME FRIEND_FULL_NAME SAY select her in the drop down under choose a friend	SAY standford MY_MAJOR MY_COMPANY | SAY yes | SELECT NAME FRIEND_FULL_NAME
START | SAY standford MY_MAJOR MY_COMPANY | SAY yes | SELECT NAME FRIEND_FULL_NAME	SAY im MY_SCHOOL MY_MAJOR MY_COMPANY SAY whats your school major and company | SAY do you know FRIEND_FULL_NAME | SELECT NAME FRIEND_FULL_NAME SAY select her in the drop down under choose a friend | PASS
START SAY upenn | SAY none of my friends work at MY_COMPANY SELECT NAME FRIEND_FULL_NAME	SAY most of my friends work at MY_COMPANY SAY MY_SCHOOL or MY_SCHOOL | SAY yep SELECT NAME FRIEND_FULL_NAME
START | SAY most of my friends work at MY_COMPANY SAY MY_SCHOOL or MY_SCHOOL | SAY yep SELECT NAME FRIEND_FULL_NAME	SAY upenn | SAY none of my friends work at MY_COMPANY SELECT NAME FRIEND_FULL_NAME | PASS
START SAY FRIEND_FULL_NAME | SAY FRIEND_FULL_NAME | SAY FRIEND_FULL_NAME SELECT NAME FRIEND_FULL_NAME	SAY MY_SCHOOL MY_MAJOR MY_COMPANY | SELECT NAME FRIEND_FULL_NAME | PASS
START | SAY MY_SCHOOL MY_MAJOR MY_COMPANY | SELECT NAME FRIEND_FULL_NAME	SAY FRIEND_FULL_NAME | SAY FRIEND_FULL_NAME | SAY FRIEND_FULL_NAME SELECT NAME FRIEND_FULL_NAME
START SAY MY_SCHOOL MY_MAJOR MY_COMPANY you | SAY i mean the information on the top right of the screen | SAY do you have FRIEND_FULL_NAME | SELECT NAME FRIEND_FULL_NAME	SAY cmu psychology unemployed rn | SAY MY_SCHOOL linguistic MY_COMPANY | SAY yes | SELECT NAME FRIEND_FULL_NAME
START | SAY cmu psychology unemployed rn | SAY MY_SCHOOL linguistic MY_COMPANY | SAY yes | SELECT NAME FRIEND_FULL_NAME	SAY MY_SCHOOL MY_MAJOR MY_COMPANY you | SAY i mean the information on the top right of the screen | SAY do you have FRIEND_FULL_NAME | SELECT NAME FRIEND_FULL_NAME | PASS
START SAY hey | SAY my friends work at MY_COMPANY mostly with one each at MY_COMPANY and MY_COMPANY SAY any company matches | SAY k SAY use the attors to sort SAY use the arrows to sort SAY well | SAY its FRIEND_FULL_NAME SELECT NAME FRIEND_FULL_NAME	SAY hello | SAY just a minute | SAY there are several matches for MY_COMPANY is there any way we can narrow it down | SELECT NAME FRIEND_FULL_NAME
START | SAY hello | SAY just a minute | SAY there are several matches for MY_COMPANY is there any way we can narrow it down | SELECT NAME FRIEND_FULL_NAME	SAY hey | SAY my friends work at MY_COMPANY mostly with one each at MY_COMPANY and MY_COMPANY SAY any company matches | SAY k SAY use the attors to sort SAY use the arrows to sort SAY well | SAY its FRIEND_FULL_NAME SELECT NAME FRIEND_FULL_NAME | PASS
START SAY MY_SCHOOL MY_MAJOR MY_COMPANY SAY my stats SAY whats your company | SELECT NAME FRIEND_FULL_NAME	SAY is you FRIEND_FULL_NAME | SELECT NAME FRIEND_FULL_NAME
START | SAY is you FRIEND_FULL_NAME | SELECT NAME FRIEND_FULL_NAME	SAY MY_SCHOOL MY_MAJOR MY_COMPANY SAY my stats SAY whats your company | SELECT NAME FRIEND_FULL_NAME | PASS
START SAY hi | SAY FRIEND_FULL_NAME | SELECT NAME FRIEND_FULL_NAME	SAY MY_SCHOOL of MY_SCHOOL major is MY_MAJOR MY_MAJOR you | SELECT NAME FRIEND_FULL_NAME | PASS
START | SAY MY_SCHOOL of MY_SCHOOL major is MY_MAJOR MY_MAJOR you | SELECT NAME FRIEND_FULL_NAME	SAY hi | SAY FRIEND_FULL_NAME | SELECT NAME FRIEND_FULL_NAME
START SAY school | SAY major SELECT NAME FRIEND_FULL_NAME | SAY anyone work for MY_COMPANY | SELECT NAME FRIEND_FULL_NAME	SAY caliberkeley SAY any friends majoring in MY_MAJOR | SAY i dont have a hersman | SAY no all from MY_COMPANY | SELECT NAME FRIEND_FULL_NAME
START | SAY caliberkeley SAY any friends majoring in MY_MAJOR | SAY i dont have a hersman | SAY no all from MY_COMPANY | SELECT NAME FRIEND_FULL_NAME	SAY school | SAY major SELECT NAME FRIEND_FULL_NAME | SAY anyone work for MY_COMPANY | SELECT NAME FRIEND_FULL_NAME | PASS
START SAY do you know FRIEND_FULL_NAME veras | SAY FRIEND_FULL_NAME SAY or FRIEND_FULL_NAME | SELECT NAME FRIEND_FULL_NAME	SAY no SAY any friends from MY_SCHOOL | SAY brigit | SAY FRIEND_FULL_NAME SELECT NAME FRIEND_FULL_NAME
START | SAY no SAY any friends from MY_SCHOOL | SAY brigit | SAY FRIEND_FULL_NAME SELECT NAME FRIEND_FULL_NAME	SAY do you know FRIEND_FULL_NAME veras | SAY FRIEND_FULL_NAME SAY or FRIEND_FULL_NAME | SELECT NAME FRIEND_FULL_NAME | PASS
START SAY hi SAY all googles two facebooks | SAY do you have anybody that works at MY_COMPANY | SAY ok | SAY i have 4 people from standford the rest MY_SCHOOL SAY no dennys not it SAY we have to find the mutual person SELECT NAME FRIEND_FULL_NAME	SAY hey | SAY 1 MY_COMPANY all MY_COMPANY | SELECT NAME FRIEND_FULL_NAME | PASS
START | SAY hey | SAY 1 MY_COMPANY all MY_COMPANY | SELECT NAME FRIEND_FULL_NAME	SAY hi SAY all googles two facebooks | SAY do you have anybody that works at MY_COMPANY | SAY ok | SAY i have 4 people from standford the rest MY_SCHOOL SAY no dennys not it SAY we have to find the mutual person SELECT NAME FRIEND_FULL_NAME
START SAY colubmia MY_MAJOR MY_COMPANY SAY you | SAY FRIEND_FULL_NAME astrogra | SAY not FRIEND_FULL_NAME | SELECT NAME FRIEND_FULL_NAME SAY i have huge balls | SAY lol | SAY i was born without one SAY select FRIEND_FULL_NAME SAY before my taint jealousy gets worse | SAY hrmm | SAY we both have FRIEND_FULL_NAME should work	SAY MY_SCHOOL MY_MAJOR MY_COMPANY | SELECT NAME FRIEND_FULL_NAME | SAY yep FRIEND_FULL_NAME | SAY same | SAY taint | SAY ive selected it like 5 times SELECT NAME FRIEND_FULL_NAME | SAY maybe if i select something else and then select FRIEND_FULL_NAME again | SAY sorry i know were losing money like this SELECT NAME FRIEND_FULL_NAME
START | SAY MY_SCHOOL MY_MAJOR MY_COMPANY | SELECT NAME FRIEND_FULL_NAME | SAY yep FRIEND_FULL_NAME | SAY same | SAY taint | SAY ive selected it like 5 times SELECT NAME FRIEND_FULL_NAME | SAY maybe if i select something else and then select FRIEND_FULL_NAME again | SAY sorry i know were losing money like this SELECT NAME FRIEND_FULL_NAME	SAY colubmia MY_MAJOR MY_COMPANY SAY you | SAY FRIEND_FULL_NAME astrogra | SAY not FRIEND_FULL_NAME | SELECT NAME FRIEND_FULL_NAME SAY i have huge balls | SAY lol | SAY i was born without one SAY select FRIEND_FULL_NAME SAY before my taint jealousy gets worse | SAY hrmm | SAY we both have FRIEND_FULL_NAME should work | PASS
START SAY any friends who work at MY_COMPANY | SELECT NAME FRIEND_FULL_NAME	SAY yes loads | SELECT NAME FRIEND_FULL_NAME
START | SAY yes loads | SELECT NAME FRIEND_FULL_NAME	SAY any friends who work at MY_COMPANY | SELECT NAME FRIEND_FULL_NAME | PASS
START SAY you know anyone from MY_SCHOOL | SAY i have one MY_COMPANY and one MY_COMPANY and the rest are MY_COMPANY | SAY that is not right SELECT NAME FRIEND_FULL_NAME	SAY mine are mostly MY_COMPANY employees but one is MY_COMPANY and one is facbook | SELECT NAME FRIEND_FULL_NAME | SELECT NAME FRIEND_FULL_NAME
START | SAY mine are mostly MY_COMPANY employees but one is MY_COMPANY and one is facbook | SELECT NAME FRIEND_FULL_NAME | SELECT NAME FRIEND_FULL_NAME	SAY you know anyone from MY_SCHOOL | SAY i have one MY_COMPANY and one MY_COMPANY and the rest are MY_COMPANY | SAY that is not right SELECT NAME FRIEND_FULL_NAME | PASS
START SAY most of my friends work at MY_COMPANY | SAY then one MY_COMPANY one MY_COMPANY | SELECT NAME FRIEND_FULL_NAME | SELECT NAME FRIEND_FULL_NAME	SAY FRIEND_FULL_NAME FRIEND_FULL_NAME FRIEND_FULL_NAME FRIEND_FULL_NAME | SAY FRIEND_FULL_NAME FRIEND_FULL_NAME FRIEND_FULL_NAME SAY FRIEND_FULL_NAME maiai FRIEND_FULL_NAME | SELECT NAME FRIEND_FULL_NAME | SELECT NAME FRIEND_FULL_NAME
START | SAY FRIEND_FULL_NAME FRIEND_FULL_NAME FRIEND_FULL_NAME FRIEND_FULL_NAME | SAY FRIEND_FULL_NAME FRIEND_FULL_NAME FRIEND_FULL_NAME SAY FRIEND_FULL_NAME maiai FRIEND_FULL_NAME | SELECT NAME FRIEND_FULL_NAME | SELECT NAME FRIEND_FULL_NAME	SAY most of my friends work at MY_COMPANY | SAY then one MY_COMPANY one MY_COMPANY | SELECT NAME FRIEND_FULL_NAME | SELECT NAME FRIEND_FULL_NAME | PASS
START SAY hello SAY MY_SCHOOL university SAY MY_MAJOR MY_COMPANY | SAY which school did you go to | SAY its at the top SAY FRIEND_FULL_NAME | SAY FRIEND_FULL_NAME | SAY brilliant SELECT NAME FRIEND_FULL_NAME	SAY yo | SAY MY_SCHOOL berke mathamazn | SAY no | SAY yes SELECT NAME FRIEND_FULL_NAME | PASS
START | SAY yo | SAY MY_SCHOOL berke mathamazn | SAY no | SAY yes SELECT NAME FRIEND_FULL_NAME	SAY hello SAY MY_SCHOOL university SAY MY_MAJOR MY_COMPANY | SAY which school did you go to | SAY its at the top SAY FRIEND_FULL_NAME | SAY FRIEND_FULL_NAME | SAY brilliant SELECT NAME FRIEND_FULL_NAME
START SAY my major is MY_MAJOR what is yours | SAY jonathan FRIEND_FULL_NAME FRIEND_FULL_NAME SELECT NAME FRIEND_FULL_NAME	SAY hi i got FRIEND_FULL_NAME FRIEND_FULL_NAME SAY MY_MAJOR SAY FRIEND_FULL_NAME FRIEND_FULL_NAME FRIEND_FULL_NAME | SELECT NAME FRIEND_FULL_NAME
START | SAY hi i got FRIEND_FULL_NAME FRIEND_FULL_NAME SAY MY_MAJOR SAY FRIEND_FULL_NAME FRIEND_FULL_NAME FRIEND_FULL_NAME | SELECT NAME FRIEND_FULL_NAME	SAY my major is MY_MAJOR what is yours | SAY jonathan FRIEND_FULL_NAME FRIEND_FULL_NAME SELECT NAME FRIEND_FULL_NAME | PASS
START SAY hi | SAY same for me with MY_SCHOOL and MY_COMPANY SAY FRIEND_FULL_NAME SELECT NAME FRIEND_FULL_NAME SAY FRIEND_FULL_NAME SAY FRIEND_FULL_NAME | SAY FRIEND_FULL_NAME | SAY dont know her | SAY randu | SELECT NAME FRIEND_FULL_NAME	SAY hey i work at MY_COMPANY and have a lot of friends there SAY also know people at MY_COMPANY and MY_COMPANY | SAY haha no no lets slow down a sec SAY i know one person at MY_COMPANY | SAY its FRIEND_FULL_NAME | SAY ok do you know anyone at MY_COMPANY | SAY FRIEND_FULL_NAME | SELECT NAME FRIEND_FULL_NAME
START | SAY hey i work at MY_COMPANY and have a lot of friends there SAY also know people at MY_COMPANY and MY_COMPANY | SAY haha no no lets slow down a sec SAY i know one person at MY_COMPANY | SAY its FRIEND_FULL_NAME | SAY ok do you know anyone at MY_COMPANY | SAY FRIEND_FULL_NAME | SELECT NAME FRIEND_FULL_NAME	SAY hi | SAY same for me with MY_SCHOOL and MY_COMPANY SAY FRIEND_FULL_NAME SELECT NAME FRIEND_FULL_NAME SAY FRIEND_FULL_NAME SAY FRIEND_FULL_NAME | SAY FRIEND_FULL_NAME | SAY dont know her | SAY randu | SELECT NAME FRIEND_FULL_NAME | PASS
START SAY 2 ubers rest MY_COMPANY | SAY FRIEND_FULL_NAME and FRIEND_FULL_NAME | SELECT NAME FRIEND_FULL_NAME	SAY names of MY_COMPANY friends SAY most of mine are MY_COMPANY no MY_COMPANY | SELECT NAME FRIEND_FULL_NAME | PASS
START | SAY names of MY_COMPANY friends SAY most of mine are MY_COMPANY no MY_COMPANY | SELECT NAME FRIEND_FULL_NAME	SAY 2 ubers rest MY_COMPANY | SAY FRIEND_FULL_NAME and FRIEND_FULL_NAME | SELECT NAME FRIEND_FULL_NAME
START SAY FRIEND_FULL_NAME | SAY FRIEND_FULL_NAME SELECT NAME FRIEND_FULL_NAME	SAY MY_SCHOOL of MY_SCHOOL major is MY_MAJOR SAY you SAY FRIEND_FULL_NAME | SELECT NAME FRIEND_FULL_NAME
START | SAY MY_SCHOOL of MY_SCHOOL major is MY_MAJOR SAY you SAY FRIEND_FULL_NAME | SELECT NAME FRIEND_FULL_NAME	SAY FRIEND_FULL_NAME | SAY FRIEND_FULL_NAME SELECT NAME FRIEND_FULL_NAME | PASS
START SAY hi | SAY hello SAY my school MY_SCHOOL of pennsyvan | SAY no | SAY FRIEND_FULL_NAME | SELECT NAME FRIEND_FULL_NAME	SAY MY_SCHOOL SAY anyone | SAY FRIEND_FULL_NAME | SAY FRIEND_FULL_NAME FRIEND_FULL_NAME FRIEND_FULL_NAME FRIEND_FULL_NAME FRIEND_FULL_NAME | SELECT NAME FRIEND_FULL_NAME | PASS
START | SAY MY_SCHOOL SAY anyone | SAY FRIEND_FULL_NAME | SAY FRIEND_FULL_NAME FRIEND_FULL_NAME FRIEND_FULL_NAME FRIEND_FULL_NAME FRIEND_FULL_NAME | SELECT NAME FRIEND_FULL_NAME	SAY hi | SAY hello SAY my school MY_SCHOOL of pennsyvan | SAY no | SAY FRIEND_FULL_NAME | SELECT NAME FRIEND_FULL_NAME
START SAY im pennsylvanin linquistics and MY_COMPANY SAY ignore the typos lol | SAY do you know FRIEND_FULL_NAME or FRIEND_FULL_NAME | SELECT NAME FRIEND_FULL_NAME	SAY MY_SCHOOL MY_MAJOR MY_COMPANY | SAY FRIEND_FULL_NAME SELECT NAME FRIEND_FULL_NAME | PASS
START | SAY MY_SCHOOL MY_MAJOR MY_COMPANY | SAY FRIEND_FULL_NAME SELECT NAME FRIEND_FULL_NAME	SAY im pennsylvanin linquistics and MY_COMPANY SAY ignore the typos lol | SAY do you know FRIEND_FULL_NAME or FRIEND_FULL_NAME | SELECT NAME FRIEND_FULL_NAME
START SAY all at MY_COMPANY except 1 at MY_COMPANY | SAY ton oli sant rive | SAY FRIEND_FULL_NAME fran than lake FRIEND_FULL_NAME gen SELECT NAME FRIEND_FULL_NAME	SAY all uc MY_SCHOOL but one at upenn SAY no MY_COMPANY here | SAY FRIEND_FULL_NAME | SELECT NAME FRIEND_FULL_NAME
START | SAY all uc MY_SCHOOL but one at upenn SAY no MY_COMPANY here | SAY FRIEND_FULL_NAME | SELECT NAME FRIEND_FULL_NAME	SAY all at MY_COMPANY except 1 at MY_COMPANY | SAY ton oli sant rive | SAY FRIEND_FULL_NAME fran than lake FRIEND_FULL_NAME gen SELECT NAME FRIEND_FULL_NAME | PASS
START SAY ucb MY_MAJOR MY_COMPANY | SAY 3 SELECT NAME FRIEND_FULL_NAME	SAY anyone on your list from MY_SCHOOL SELECT NAME FRIEND_FULL_NAME | PASS
START | SAY anyone on your list from MY_SCHOOL SELECT NAME FRIEND_FULL_NAME	SAY ucb MY_MAJOR MY_COMPANY | SAY 3 SELECT NAME FRIEND_FULL_NAME
START SAY all firends work for MY_COMPANY but one SAY FRIEND_FULL_NAME | SELECT NAME FRIEND_FULL_NAME	SAY FRIEND_FULL_NAME FRIEND_FULL_NAME FRIEND_FULL_NAME FRIEND_FULL_NAME | SELECT NAME FRIEND_FULL_NAME
START | SAY FRIEND_FULL_NAME FRIEND_FULL_NAME FRIEND_FULL_NAME FRIEND_FULL_NAME | SELECT NAME FRIEND_FULL_NAME	SAY all firends work for MY_COMPANY but one SAY FRIEND_FULL_NAME | SELECT NAME FRIEND_FULL_NAME | PASS
START SAY FRIEND_FULL_NAME SAY FRIEND_FULL_NAME SAY FRIEND_FULL_NAME | SAY FRIEND_FULL_NAME | SAY nathan | SAY brittani | SAY FRIEND_FULL_NAME SAY FRIEND_FULL_NAME | SAY FRIEND_FULL_NAME SELECT NAME FRIEND_FULL_NAME	SAY FRIEND_FULL_NAME | SAY FRIEND_FULL_NAME | SAY FRIEND_FULL_NAME | SAY FRIEND_FULL_NAME | SAY FRIEND_FULL_NAME | SELECT NAME FRIEND_FULL_NAME
START | SAY FRIEND_FULL_NAME | SAY FRIEND_FULL_NAME | SAY FRIEND_FULL_NAME | SAY FRIEND_FULL_NAME | SAY FRIEND_FULL_NAME | SELECT NAME FRIEND_FULL_NAME	SAY FRIEND_FULL_NAME SAY FRIEND_FULL_NAME SAY FRIEND_FULL_NAME | SAY FRIEND_FULL_NAME | SAY nathan | SAY brittani | SAY FRIEND_FULL_NAME SAY FRIEND_FULL_NAME | SAY FRIEND_FULL_NAME SELECT NAME FRIEND_FULL_NAME | PASS
START SAY FRIEND_FULL_NAME SAY FRIEND_FULL_NAME SAY FRIEND_FULL_NAME SAY FRIEND_FULL_NAME SAY FRIEND_FULL_NAME | SELECT NAME FRIEND_FULL_NAME	SELECT NAME FRIEND_FULL_NAME | PASS
START | SELECT NAME FRIEND_FULL_NAME	SAY FRIEND_FULL_NAME SAY FRIEND_FULL_NAME SAY FRIEND_FULL_NAME SAY FRIEND_FULL_NAME SAY FRIEND_FULL_NAME | SELECT NAME FRIEND_FULL_NAME
START SAY hi SAY all my friends work at MY_COMPANY but 1 at MY_COMPANY | SAY MY_MAJOR FRIEND_FULL_NAME and FRIEND_FULL_NAME SAY MY_MAJOR FRIEND_FULL_NAME FRIEND_FULL_NAME SAY please respond | SAY MY_MAJOR | SELECT NAME FRIEND_FULL_NAME	SAY do they major in MY_MAJOR or MY_MAJOR | SAY where does the one who works at MY_COMPANY work SAY i mean major | SELECT NAME FRIEND_FULL_NAME | PASS
START | SAY do they major in MY_MAJOR or MY_MAJOR | SAY where does the one who works at MY_COMPANY work SAY i mean major | SELECT NAME FRIEND_FULL_NAME	SAY hi SAY all my friends work at MY_COMPANY but 1 at MY_COMPANY | SAY MY_MAJOR FRIEND_FULL_NAME and FRIEND_FULL_NAME SAY MY_MAJOR FRIEND_FULL_NAME FRIEND_FULL_NAME SAY please respond | SAY MY_MAJOR | SELECT NAME FRIEND_FULL_NAME
START SAY 1 MY_COMPANY rest MY_COMPANY | SELECT NAME FRIEND_FULL_NAME	SAY i have one friend from MY_COMPANY rest MY_COMPANY SAY MY_COMPANY FRIEND_FULL_NAME SAY whos your MY_COMPANY friend | SELECT NAME FRIEND_FULL_NAME
START | SAY i have one friend from MY_COMPANY rest MY_COMPANY SAY MY_COMPANY FRIEND_FULL_NAME SAY whos your MY_COMPANY friend | SELECT NAME FRIEND_FULL_NAME	SAY 1 MY_COMPANY rest MY_COMPANY | SELECT NAME FRIEND_FULL_NAME | PASS
START SAY most of my friends work at MY_COMPANY SAY except FRIEND_FULL_NAME and FRIEND_FULL_NAME SAY hello | SAY cmon time is money SELECT NAME FRIEND_FULL_NAME	SAY hi | SELECT NAME FRIEND_FULL_NAME
START | SAY hi | SELECT NAME FRIEND_FULL_NAME	SAY most of my friends work at MY_COMPANY SAY except FRIEND_FULL_NAME and FRIEND_FULL_NAME SAY hello | SAY cmon time is money SELECT NAME FRIEND_FULL_NAME | PASS
START SAY hi | SAY i have one MY_COMPANY friend rest are all MY_COMPANY | SAY yep SAY FRIEND_FULL_NAME SELECT NAME FRIEND_FULL_NAME	SAY hi | SAY FRIEND_FULL_NAME SAY FRIEND_FULL_NAME | SELECT NAME FRIEND_FULL_NAME
START | SAY hi | SAY FRIEND_FULL_NAME SAY FRIEND_FULL_NAME | SELECT NAME FRIEND_FULL_NAME	SAY hi | SAY i have one MY_COMPANY friend rest are all MY_COMPANY | SAY yep SAY FRIEND_FULL_NAME SELECT NAME FRIEND_FULL_NAME | PASS
START SAY MY_SCHOOL MY_MAJOR MY_COMPANY | SAY no | SAY no | SAY no | SAY no MY_COMPANY SAY FRIEND_FULL_NAME SAY FRIEND_FULL_NAME | SELECT NAME FRIEND_FULL_NAME	SAY FRIEND_FULL_NAME | SAY FRIEND_FULL_NAME | SAY FRIEND_FULL_NAME | SAY MY_COMPANY SAY MY_MAJOR SAY MY_SCHOOL | SAY FRIEND_FULL_NAME | SELECT NAME FRIEND_FULL_NAME
START | SAY FRIEND_FULL_NAME | SAY FRIEND_FULL_NAME | SAY FRIEND_FULL_NAME | SAY MY_COMPANY SAY MY_MAJOR SAY MY_SCHOOL | SAY FRIEND_FULL_NAME | SELECT NAME FRIEND_FULL_NAME	SAY MY_SCHOOL MY_MAJOR MY_COMPANY | SAY no | SAY no | SAY no | SAY no MY_COMPANY SAY FRIEND_FULL_NAME SAY FRIEND_FULL_NAME | SELECT NAME FRIEND_FULL_NAME | PASS
START SAY hi | SAY do you have any friends at MY_COMPANY or MY_COMPANY | SAY FRIEND_FULL_NAME SELECT NAME FRIEND_FULL_NAME	SAY university of calberkley MY_MAJOR MY_COMPANY | SAY yea pulley ghee bybee SAY all MY_COMPANY | SELECT NAME FRIEND_FULL_NAME
START | SAY university of calberkley MY_MAJOR MY_COMPANY | SAY yea pulley ghee bybee SAY all MY_COMPANY | SELECT NAME FRIEND_FULL_NAME	SAY hi | SAY do you have any friends at MY_COMPANY or MY_COMPANY | SAY FRIEND_FULL_NAME SELECT NAME FRIEND_FULL_NAME | PASS
START SAY hello friend | SAY anyone at upenn | SAY oh FRIEND_FULL_NAME | SAY alren landers | SELECT NAME FRIEND_FULL_NAME	SAY ih | SAY all MY_COMPANY | SAY FRIEND_FULL_NAME | SELECT NAME FRIEND_FULL_NAME | PASS
START | SAY ih | SAY all MY_COMPANY | SAY FRIEND_FULL_NAME | SELECT NAME FRIEND_FULL_NAME	SAY hello friend | SAY anyone at upenn | SAY oh FRIEND_FULL_NAME | SAY alren landers | SELECT NAME FRIEND_FULL_NAME
START SAY FRIEND_FULL_NAME flethcher FRIEND_FULL_NAME | SAY FRIEND_FULL_NAME FRIEND_FULL_NAME FRIEND_FULL_NAME | SELECT NAME FRIEND_FULL_NAME	SAY MY_SCHOOL of MY_SCHOOL MY_MAJOR MY_MAJOR | SELECT NAME FRIEND_FULL_NAME | PASS
START | SAY MY_SCHOOL of MY_SCHOOL MY_MAJOR MY_MAJOR | SELECT NAME FRIEND_FULL_NAME	SAY FRIEND_FULL_NAME flethcher FRIEND_FULL_NAME | SAY FRIEND_FULL_NAME FRIEND_FULL_NAME FRIEND_FULL_NAME | SELECT NAME FRIEND_FULL_NAME
START SAY fletch sher FRIEND_FULL_NAME FRIEND_FULL_NAME SAY lash FRIEND_FULL_NAME ren lau den sam SAY FRIEND_FULL_NAME | SELECT NAME FRIEND_FULL_NAME	SELECT NAME FRIEND_FULL_NAME | PASS
START | SELECT NAME FRIEND_FULL_NAME	SAY fletch sher FRIEND_FULL_NAME FRIEND_FULL_NAME SAY lash FRIEND_FULL_NAME ren lau den sam SAY FRIEND_FULL_NAME | SELECT NAME FRIEND_FULL_NAME
START SAY hi | SAY berkley MY_MAJOR MY_COMPANY here | SELECT NAME FRIEND_FULL_NAME	SAY FRIEND_FULL_NAME | SAY FRIEND_FULL_NAME SAY FRIEND_FULL_NAME SAY FRIEND_FULL_NAME SAY FRIEND_FULL_NAME SAY FRIEND_FULL_NAME | SAY FRIEND_FULL_NAME SELECT NAME FRIEND_FULL_NAME
START | SAY FRIEND_FULL_NAME | SAY FRIEND_FULL_NAME SAY FRIEND_FULL_NAME SAY FRIEND_FULL_NAME SAY FRIEND_FULL_NAME SAY FRIEND_FULL_NAME | SAY FRIEND_FULL_NAME SELECT NAME FRIEND_FULL_NAME	SAY hi | SAY berkley MY_MAJOR MY_COMPANY here | SELECT NAME FRIEND_FULL_NAME | PASS
START SAY hi friend | SAY MY_SCHOOL MY_MAJOR MY_COMPANY | SAY yup | SAY well that was easy | SELECT NAME FRIEND_FULL_NAME	SAY hello SAY uc MY_SCHOOL MY_MAJOR MY_COMPANY you | SAY FRIEND_FULL_NAME | SAY awesome | SELECT NAME FRIEND_FULL_NAME | PASS
START | SAY hello SAY uc MY_SCHOOL MY_MAJOR MY_COMPANY you | SAY FRIEND_FULL_NAME | SAY awesome | SELECT NAME FRIEND_FULL_NAME	SAY hi friend | SAY MY_SCHOOL MY_MAJOR MY_COMPANY | SAY yup | SAY well that was easy | SELECT NAME FRIEND_FULL_NAME
START SAY MY_SCHOOL MY_MAJOR MY_COMPANY my stats | SAY hi | SAY FRIEND_FULL_NAME SELECT NAME FRIEND_FULL_NAME	SAY hi there | SAY berkely MY_MAJOR MY_MAJOR MY_COMPANY SAY do you know FRIEND_FULL_NAME | SELECT NAME FRIEND_FULL_NAME
START | SAY hi there | SAY berkely MY_MAJOR MY_MAJOR MY_COMPANY SAY do you know FRIEND_FULL_NAME | SELECT NAME FRIEND_FULL_NAME	SAY MY_SCHOOL MY_MAJOR MY_COMPANY my stats | SAY hi | SAY FRIEND_FULL_NAME SELECT NAME FRIEND_FULL_NAME | PASS
START SELECT NAME FRIEND_FULL_NAME	SELECT NAME FRIEND_FULL_NAME
START | SELECT NAME FRIEND_FULL_NAME	SELECT NAME FRIEND_FULL_NAME | PASS
START SAY hi | SAY i have one MY_COMPANY one MY_COMPANY one MY_COMPANY the rest MY_COMPANY | SAY FRIEND_FULL_NAME at MY_COMPANY SAY or FRIEND_FULL_NAME at MY_COMPANY SAY whos your MY_COMPANY | SELECT NAME FRIEND_FULL_NAME	SAY hi | SAY one MY_COMPANY one MY_COMPANY the rest MY_COMPANY | SAY FRIEND_FULL_NAME SAY at MY_COMPANY SELECT NAME FRIEND_FULL_NAME | PASS
START | SAY hi | SAY one MY_COMPANY one MY_COMPANY the rest MY_COMPANY | SAY FRIEND_FULL_NAME SAY at MY_COMPANY SELECT NAME FRIEND_FULL_NAME	SAY hi | SAY i have one MY_COMPANY one MY_COMPANY one MY_COMPANY the rest MY_COMPANY | SAY FRIEND_FULL_NAME at MY_COMPANY SAY or FRIEND_FULL_NAME at MY_COMPANY SAY whos your MY_COMPANY | SELECT NAME FRIEND_FULL_NAME
START SAY MY_SCHOOL MY_MAJOR MY_COMPANY | SAY nope | SAY nope | SAY FRIEND_FULL_NAME | SELECT NAME FRIEND_FULL_NAME	SAY lorraine FRIEND_FULL_NAME FRIEND_FULL_NAME | SAY FRIEND_FULL_NAME FRIEND_FULL_NAME FRIEND_FULL_NAME | SAY FRIEND_FULL_NAME FRIEND_FULL_NAME | SAY FRIEND_FULL_NAME FRIEND_FULL_NAME SELECT NAME FRIEND_FULL_NAME | PASS
START | SAY lorraine FRIEND_FULL_NAME FRIEND_FULL_NAME | SAY FRIEND_FULL_NAME FRIEND_FULL_NAME FRIEND_FULL_NAME | SAY FRIEND_FULL_NAME FRIEND_FULL_NAME | SAY FRIEND_FULL_NAME FRIEND_FULL_NAME SELECT NAME FRIEND_FULL_NAME	SAY MY_SCHOOL MY_MAJOR MY_COMPANY | SAY nope | SAY nope | SAY FRIEND_FULL_NAME | SELECT NAME FRIEND_FULL_NAME
START SAY all MY_COMPANY | SAY what is your MY_COMPANY | SELECT NAME FRIEND_FULL_NAME	SAY one MY_COMPANY the rest MY_COMPANY | SAY FRIEND_FULL_NAME | SELECT NAME FRIEND_FULL_NAME
START | SAY one MY_COMPANY the rest MY_COMPANY | SAY FRIEND_FULL_NAME | SELECT NAME FRIEND_FULL_NAME	SAY all MY_COMPANY | SAY what is your MY_COMPANY | SELECT NAME FRIEND_FULL_NAME | PASS
START SAY MY_SCHOOL MY_MAJOR MY_COMPANY SAY whats your school major company | SELECT NAME FRIEND_FULL_NAME	SAY MY_SCHOOL MY_MAJOR MY_COMPANY | SELECT NAME FRIEND_FULL_NAME
START | SAY MY_SCHOOL MY_MAJOR MY_COMPANY | SELECT NAME FRIEND_FULL_NAME	SAY MY_SCHOOL MY_MAJOR MY_COMPANY SAY whats your school major company | SELECT NAME FRIEND_FULL_NAME | PASS
START SAY all ubder one MY_COMPANY one MY_COMPANY | SELECT NAME FRIEND_FULL_NAME	SAY all MY_COMPANY one MY_COMPANY | SAY mine MY_SCHOOL MY_MAJOR MY_COMPANY SELECT NAME FRIEND_FULL_NAME
START | SAY all MY_COMPANY one MY_COMPANY | SAY mine MY_SCHOOL MY_MAJOR MY_COMPANY SELECT NAME FRIEND_FULL_NAME	SAY all ubder one MY_COMPANY one MY_COMPANY | SELECT NAME FRIEND_FULL_NAME | PASS
START SAY hello SAY FRIEND_FULL_NAME SAY FRIEND_FULL_NAME SAY FRIEND_FULL_NAME SAY FRIEND_FULL_NAME SAY FRIEND_FULL_NAME | SELECT NAME FRIEND_FULL_NAME	SELECT NAME FRIEND_FULL_NAME | PASS
START | SELECT NAME FRIEND_FULL_NAME	SAY hello SAY FRIEND_FULL_NAME SAY FRIEND_FULL_NAME SAY FRIEND_FULL_NAME SAY FRIEND_FULL_NAME SAY FRIEND_FULL_NAME | SELECT NAME FRIEND_FULL_NAME
START SAY ive got one MY_COMPANY friend FRIEND_FULL_NAME rest are MY_COMPANY | SELECT NAME FRIEND_FULL_NAME	SAY i only have 1 MY_COMPANY friend FRIEND_FULL_NAME rest are MY_COMPANY | SELECT NAME FRIEND_FULL_NAME
START | SAY i only have 1 MY_COMPANY friend FRIEND_FULL_NAME rest are MY_COMPANY | SELECT NAME FRIEND_FULL_NAME	SAY ive got one MY_COMPANY friend FRIEND_FULL_NAME rest are MY_COMPANY | SELECT NAME FRIEND_FULL_NAME | PASS
START SAY fletch just tys FRIEND_FULL_NAME den SAY FRIEND_FULL_NAME bri brit SAY jes lash | SELECT NAME FRIEND_FULL_NAME	SELECT NAME FRIEND_FULL_NAME | PASS
START | SELECT NAME FRIEND_FULL_NAME	SAY fletch just tys FRIEND_FULL_NAME den SAY FRIEND_FULL_NAME bri brit SAY jes lash | SELECT NAME FRIEND_FULL_NAME
START SAY MY_SCHOOL | SAY who SELECT NAME FRIEND_FULL_NAME	SAY only one SAY FRIEND_FULL_NAME | SELECT NAME FRIEND_FULL_NAME
START | SAY only one SAY FRIEND_FULL_NAME | SELECT NAME FRIEND_FULL_NAME	SAY MY_SCHOOL | SAY who SELECT NAME FRIEND_FULL_NAME | PASS
START SAY hi i go to MY_SCHOOL you | SAY major SAY mine is MY_MAJOR company is MY_COMPANY SELECT NAME FRIEND_FULL_NAME | SELECT NAME FRIEND_FULL_NAME | SELECT NAME FRIEND_FULL_NAME	SAY university of MY_SCHOOL berkley SELECT NAME FRIEND_FULL_NAME | SAY MY_MAJOR work for MY_COMPANY | SELECT NAME FRIEND_FULL_NAME | PASS
START | SAY university of MY_SCHOOL berkley SELECT NAME FRIEND_FULL_NAME | SAY MY_MAJOR work for MY_COMPANY | SELECT NAME FRIEND_FULL_NAME	SAY hi i go to MY_SCHOOL you | SAY major SAY mine is MY_MAJOR company is MY_COMPANY SELECT NAME FRIEND_FULL_NAME | SELECT NAME FRIEND_FULL_NAME | SELECT NAME FRIEND_FULL_NAME
START SAY FRIEND_FULL_NAME | SAY FRIEND_FULL_NAME SELECT NAME FRIEND_FULL_NAME	SELECT NAME FRIEND_FULL_NAME | PASS
START | SELECT NAME FRIEND_FULL_NAME	SAY FRIEND_FULL_NAME | SAY FRIEND_FULL_NAME SELECT NAME FRIEND_FULL_NAME
START SAY hi | SAY no | SAY neither | SAY MY_MAJOR SAY uc MY_SCHOOL | SAY all MY_COMPANY | SELECT NAME FRIEND_FULL_NAME	SAY MY_SCHOOL MY_MAJOR SAY FRIEND_FULL_NAME | SAY zack or FRIEND_FULL_NAME | SAY your major and college | SELECT NAME FRIEND_FULL_NAME SAY company | SELECT NAME FRIEND_FULL_NAME | PASS
START | SAY MY_SCHOOL MY_MAJOR SAY FRIEND_FULL_NAME | SAY zack or FRIEND_FULL_NAME | SAY your major and college | SELECT NAME FRIEND_FULL_NAME SAY company | SELECT NAME FRIEND_FULL_NAME	SAY hi | SAY no | SAY neither | SAY MY_MAJOR SAY uc MY_SCHOOL | SAY all MY_COMPANY | SELECT NAME FRIEND_FULL_NAME
START SELECT NAME FRIEND_FULL_NAME | SAY hello | SAY excuse me | SELECT NAME FRIEND_FULL_NAME	SAY hi | SAY say SAY i have FRIEND_FULL_NAME har FRIEND_FULL_NAME | SAY FRIEND_FULL_NAME | SAY your friend list matched anyone SELECT NAME FRIEND_FULL_NAME
START | SAY hi | SAY say SAY i have FRIEND_FULL_NAME har FRIEND_FULL_NAME | SAY FRIEND_FULL_NAME | SAY your friend list matched anyone SELECT NAME FRIEND_FULL_NAME	SELECT NAME FRIEND_FULL_NAME | SAY hello | SAY excuse me | SELECT NAME FRIEND_FULL_NAME | PASS
START SAY hi | SAY dont know him | SAY i know plenty of people at MY_COMPANY SAY nope SAY know anyone from upenn | SAY nope SELECT NAME FRIEND_FULL_NAME | SELECT NAME FRIEND_FULL_NAME | SELECT NAME FRIEND_FULL_NAME	SELECT NAME FRIEND_FULL_NAME | SELECT NAME FRIEND_FULL_NAME | SELECT NAME FRIEND_FULL_NAME | SELECT NAME FRIEND_FULL_NAME | SELECT NAME FRIEND_FULL_NAME | PASS
START | SELECT NAME FRIEND_FULL_NAME | SELECT NAME FRIEND_FULL_NAME | SELECT NAME FRIEND_FULL_NAME | SELECT NAME FRIEND_FULL_NAME | SELECT NAME FRIEND_FULL_NAME	SAY hi | SAY dont know him | SAY i know plenty of people at MY_COMPANY SAY nope SAY know anyone from upenn | SAY nope SELECT NAME FRIEND_FULL_NAME | SELECT NAME FRIEND_FULL_NAME | SELECT NAME FRIEND_FULL_NAME
START SAY hello do you know FRIEND_FULL_NAME SAY FRIEND_FULL_NAME FRIEND_FULL_NAME FRIEND_FULL_NAME | SAY FRIEND_FULL_NAME FRIEND_FULL_NAME | SAY i went to MY_SCHOOL MY_MAJOR MY_COMPANY | SAY yes | SELECT NAME FRIEND_FULL_NAME	SAY no MY_SCHOOL MY_MAJOR MY_MAJOR MY_COMPANY | SAY no | SAY FRIEND_FULL_NAME | SELECT NAME FRIEND_FULL_NAME | PASS
START | SAY no MY_SCHOOL MY_MAJOR MY_MAJOR MY_COMPANY | SAY no | SAY FRIEND_FULL_NAME | SELECT NAME FRIEND_FULL_NAME	SAY hello do you know FRIEND_FULL_NAME SAY FRIEND_FULL_NAME FRIEND_FULL_NAME FRIEND_FULL_NAME | SAY FRIEND_FULL_NAME FRIEND_FULL_NAME | SAY i went to MY_SCHOOL MY_MAJOR MY_COMPANY | SAY yes | SELECT NAME FRIEND_FULL_NAME
START SAY hi there | SAY MY_SCHOOL MY_MAJOR MY_COMPANY | SAY do you know FRIEND_FULL_NAME corter | SAY ok what about FRIEND_FULL_NAME SAY no i dont know lian | SAY cool | SELECT NAME FRIEND_FULL_NAME	SAY MY_SCHOOL MY_MAJOR MY_COMPANY | SAY hi | SAY no SAY do you lian | SAY FRIEND_FULL_NAME yes | SELECT NAME FRIEND_FULL_NAME | PASS
START | SAY MY_SCHOOL MY_MAJOR MY_COMPANY | SAY hi | SAY no SAY do you lian | SAY FRIEND_FULL_NAME yes | SELECT NAME FRIEND_FULL_NAME	SAY hi there | SAY MY_SCHOOL MY_MAJOR MY_COMPANY | SAY do you know FRIEND_FULL_NAME corter | SAY ok what about FRIEND_FULL_NAME SAY no i dont know lian | SAY cool | SELECT NAME FRIEND_FULL_NAME
START SAY do you know FRIEND_FULL_NAME SAY or FRIEND_FULL_NAME | SAY i know FRIEND_FULL_NAME SELECT NAME FRIEND_FULL_NAME	SAY no my friends are mostly at MY_COMPANY SAY only FRIEND_FULL_NAME at MY_COMPANY | SELECT NAME FRIEND_FULL_NAME
START | SAY no my friends are mostly at MY_COMPANY SAY only FRIEND_FULL_NAME at MY_COMPANY | SELECT NAME FRIEND_FULL_NAME	SAY do you know FRIEND_FULL_NAME SAY or FRIEND_FULL_NAME | SAY i know FRIEND_FULL_NAME SELECT NAME FRIEND_FULL_NAME | PASS
START SAY all friends but one at MY_COMPANY | SAY FRIEND_FULL_NAME | SELECT NAME FRIEND_FULL_NAME	SAY no fb here | SELECT NAME FRIEND_FULL_NAME | PASS
START | SAY no fb here | SELECT NAME FRIEND_FULL_NAME	SAY all friends but one at MY_COMPANY | SAY FRIEND_FULL_NAME | SELECT NAME FRIEND_FULL_NAME
START SAY FRIEND_FULL_NAME | SAY FRIEND_FULL_NAME SAY FRIEND_FULL_NAME | SAY MY_MAJOR MY_COMPANY only | SAY no other MY_MAJOR SELECT NAME FRIEND_FULL_NAME	SAY hi there MY_SCHOOL MY_MAJOR MY_COMPANY | SAY FRIEND_FULL_NAME SAY FRIEND_FULL_NAME SAY FRIEND_FULL_NAME SAY FRIEND_FULL_NAME | SAY FRIEND_FULL_NAME | SELECT NAME FRIEND_FULL_NAME
START | SAY hi there MY_SCHOOL MY_MAJOR MY_COMPANY | SAY FRIEND_FULL_NAME SAY FRIEND_FULL_NAME SAY FRIEND_FULL_NAME SAY FRIEND_FULL_NAME | SAY FRIEND_FULL_NAME | SELECT NAME FRIEND_FULL_NAME	SAY FRIEND_FULL_NAME | SAY FRIEND_FULL_NAME SAY FRIEND_FULL_NAME | SAY MY_MAJOR MY_COMPANY only | SAY no other MY_MAJOR SELECT NAME FRIEND_FULL_NAME | PASS
START SAY MY_COMPANY MY_COMPANY or MY_COMPANY SAY hello SAY you there SAY hi | SAY i have friends at goofle MY_COMPANY and MY_COMPANY SAY do you | SAY no thats not it | SAY MY_COMPANY SAY i have no MY_COMPANY friends SAY its MY_COMPANY or MY_COMPANY | SAY thats it SELECT NAME FRIEND_FULL_NAME	SAY hello | SAY 1 MY_COMPANY lucienna | SAY 1 MY_COMPANY FRIEND_FULL_NAME | SAY 1 MY_COMPANY FRIEND_FULL_NAME | SELECT NAME FRIEND_FULL_NAME
START | SAY hello | SAY 1 MY_COMPANY lucienna | SAY 1 MY_COMPANY FRIEND_FULL_NAME | SAY 1 MY_COMPANY FRIEND_FULL_NAME | SELECT NAME FRIEND_FULL_NAME	SAY MY_COMPANY MY_COMPANY or MY_COMPANY SAY hello SAY you there SAY hi | SAY i have friends at goofle MY_COMPANY and MY_COMPANY SAY do you | SAY no thats not it | SAY MY_COMPANY SAY i have no MY_COMPANY friends SAY its MY_COMPANY or MY_COMPANY | SAY thats it SELECT NAME FRIEND_FULL_NAME | PASS
START SAY hi | SAY lshaunda FRIEND_FULL_NAME FRIEND_FULL_NAME FRIEND_FULL_NAME FRIEND_FULL_NAME | SAY no | SAY FRIEND_FULL_NAME FRIEND_FULL_NAME FRIEND_FULL_NAME FRIEND_FULL_NAME FRIEND_FULL_NAME SAY no | SAY no | SAY thats all of mine | SAY no | SAY no SAY FRIEND_FULL_NAME | SAY not on my list | SAY ok SELECT NAME FRIEND_FULL_NAME	SAY FRIEND_FULL_NAME SAY FRIEND_FULL_NAME | SAY FRIEND_FULL_NAME | SAY nope SAY FRIEND_FULL_NAME | SAY FRIEND_FULL_NAME | SAY nope | SAY FRIEND_FULL_NAME | SAY FRIEND_FULL_NAME | SELECT NAME FRIEND_FULL_NAME SAY FRIEND_FULL_NAME | SAY you pasted it | PASS
START | SAY FRIEND_FULL_NAME SAY FRIEND_FULL_NAME | SAY FRIEND_FULL_NAME | SAY nope SAY FRIEND_FULL_NAME | SAY FRIEND_FULL_NAME | SAY nope | SAY FRIEND_FULL_NAME | SAY FRIEND_FULL_NAME | SELECT NAME FRIEND_FULL_NAME SAY FRIEND_FULL_NAME | SAY you pasted it	SAY hi | SAY lshaunda FRIEND_FULL_NAME FRIEND_FULL_NAME FRIEND_FULL_NAME FRIEND_FULL_NAME | SAY no | SAY FRIEND_FULL_NAME FRIEND_FULL_NAME FRIEND_FULL_NAME FRIEND_FULL_NAME FRIEND_FULL_NAME SAY no | SAY no | SAY thats all of mine | SAY no | SAY no SAY FRIEND_FULL_NAME | SAY not on my list | SAY ok SELECT NAME FRIEND_FULL_NAME
START SAY did any of your friends go to MY_SCHOOL or MY_SCHOOL | SELECT NAME FRIEND_FULL_NAME	SAY yeah quin FRIEND_FULL_NAME FRIEND_FULL_NAME FRIEND_FULL_NAME FRIEND_FULL_NAME | SELECT NAME FRIEND_FULL_NAME
START | SAY yeah quin FRIEND_FULL_NAME FRIEND_FULL_NAME FRIEND_FULL_NAME FRIEND_FULL_NAME | SELECT NAME FRIEND_FULL_NAME	SAY did any of your friends go to MY_SCHOOL or MY_SCHOOL | SELECT NAME FRIEND_FULL_NAME | PASS
START SAY friends SAY FRIEND_FULL_NAME SAY clroinda | SAY FRIEND_FULL_NAME SELECT NAME FRIEND_FULL_NAME	SAY FRIEND_FULL_NAME | SELECT NAME FRIEND_FULL_NAME
START | SAY FRIEND_FULL_NAME | SELECT NAME FRIEND_FULL_NAME	SAY friends SAY FRIEND_FULL_NAME SAY clroinda | SAY FRIEND_FULL_NAME SELECT NAME FRIEND_FULL_NAME | PASS
START SELECT NAME FRIEND_FULL_NAME | SELECT NAME FRIEND_FULL_NAME	SELECT NAME FRIEND_FULL_NAME SELECT NAME FRIEND_FULL_NAME | PASS
START | SELECT NAME FRIEND_FULL_NAME SELECT NAME FRIEND_FULL_NAME	SELECT NAME FRIEND_FULL_NAME | SELECT NAME FRIEND_FULL_NAME
START SAY hi SAY i have all amazons one MY_COMPANY | SAY yep SELECT NAME FRIEND_FULL_NAME	SAY ok FRIEND_FULL_NAME SAY only MY_COMPANY i have | SELECT NAME FRIEND_FULL_NAME
START | SAY ok FRIEND_FULL_NAME SAY only MY_COMPANY i have | SELECT NAME FRIEND_FULL_NAME	SAY hi SAY i have all amazons one MY_COMPANY | SAY yep SELECT NAME FRIEND_FULL_NAME | PASS
START SAY most MY_COMPANY ttwo MY_COMPANY and one MY_COMPANY | SAY i am at MY_SCHOOL SAY neither | SAY none | SELECT NAME FRIEND_FULL_NAME | SAY FRIEND_FULL_NAME	SAY MY_COMPANY FRIEND_FULL_NAME or FRIEND_FULL_NAME | SAY FRIEND_FULL_NAME FRIEND_FULL_NAME FRIEND_FULL_NAME | SAY FRIEND_FULL_NAME FRIEND_FULL_NAME | SAY lashauna | SELECT NAME FRIEND_FULL_NAME
START | SAY MY_COMPANY FRIEND_FULL_NAME or FRIEND_FULL_NAME | SAY FRIEND_FULL_NAME FRIEND_FULL_NAME FRIEND_FULL_NAME | SAY FRIEND_FULL_NAME FRIEND_FULL_NAME | SAY lashauna | SELECT NAME FRIEND_FULL_NAME	SAY most MY_COMPANY ttwo MY_COMPANY and one MY_COMPANY | SAY i am at MY_SCHOOL SAY neither | SAY none | SELECT NAME FRIEND_FULL_NAME | SAY FRIEND_FULL_NAME | PASS
START SAY hi | SAY no | SAY no | SAY FRIEND_FULL_NAME | SAY FRIEND_FULL_NAME | SELECT NAME FRIEND_FULL_NAME	SAY gen FRIEND_FULL_NAME mit FRIEND_FULL_NAME SAY FRIEND_FULL_NAME SAY m SAY FRIEND_FULL_NAME | SAY FRIEND_FULL_NAME | SAY FRIEND_FULL_NAME SAY FRIEND_FULL_NAME | SAY FRIEND_FULL_NAME | SELECT NAME FRIEND_FULL_NAME | PASS
START | SAY gen FRIEND_FULL_NAME mit FRIEND_FULL_NAME SAY FRIEND_FULL_NAME SAY m SAY FRIEND_FULL_NAME | SAY FRIEND_FULL_NAME | SAY FRIEND_FULL_NAME SAY FRIEND_FULL_NAME | SAY FRIEND_FULL_NAME | SELECT NAME FRIEND_FULL_NAME	SAY hi | SAY no | SAY no | SAY FRIEND_FULL_NAME | SAY FRIEND_FULL_NAME | SELECT NAME FRIEND_FULL_NAME
START SELECT NAME FRIEND_FULL_NAME | SELECT NAME FRIEND_FULL_NAME	SAY MY_SCHOOL MY_MAJOR MY_COMPANY SAY nope | SELECT NAME FRIEND_FULL_NAME
START | SAY MY_SCHOOL MY_MAJOR MY_COMPANY SAY nope | SELECT NAME FRIEND_FULL_NAME	SELECT NAME FRIEND_FULL_NAME | SELECT NAME FRIEND_FULL_NAME | PASS
START SAY hi | SAY know anyone at MY_COMPANY | SAY what is the name | SAY cool SELECT NAME FRIEND_FULL_NAME	SAY hello any MY_COMPANY friends | SAY i have one MY_COMPANY and the rest MY_COMPANY | SAY FRIEND_FULL_NAME | SELECT NAME FRIEND_FULL_NAME
START | SAY hello any MY_COMPANY friends | SAY i have one MY_COMPANY and the rest MY_COMPANY | SAY FRIEND_FULL_NAME | SELECT NAME FRIEND_FULL_NAME	SAY hi | SAY know anyone at MY_COMPANY | SAY what is the name | SAY cool SELECT NAME FRIEND_FULL_NAME | PASS
START SELECT NAME FRIEND_FULL_NAME | SELECT NAME FRIEND_FULL_NAME	SELECT NAME FRIEND_FULL_NAME | PASS
START | SELECT NAME FRIEND_FULL_NAME	SELECT NAME FRIEND_FULL_NAME | SELECT NAME FRIEND_FULL_NAME
START SAY MY_SCHOOL | SAY FRIEND_FULL_NAME | SAY MY_MAJOR | SAY mostly MY_COMPANY SAY your major | SELECT NAME FRIEND_FULL_NAME	SAY university of MY_SCHOOL | SAY major | SAY FRIEND_FULL_NAME SAY MY_MAJOR | SAY clarissa | SELECT NAME FRIEND_FULL_NAME
START | SAY university of MY_SCHOOL | SAY major | SAY FRIEND_FULL_NAME SAY MY_MAJOR | SAY clarissa | SELECT NAME FRIEND_FULL_NAME	SAY MY_SCHOOL | SAY FRIEND_FULL_NAME | SAY MY_MAJOR | SAY mostly MY_COMPANY SAY your major | SELECT NAME FRIEND_FULL_NAME | PASS
START SAY hey | SAY so what school are you from | SAY im a MY_MAJOR major at MY_SCHOOL what are you studying | SELECT NAME FRIEND_FULL_NAME	SAY hello | SAY MY_SCHOOL and you | SAY MY_MAJOR | SELECT NAME FRIEND_FULL_NAME
START | SAY hello | SAY MY_SCHOOL and you | SAY MY_MAJOR | SELECT NAME FRIEND_FULL_NAME	SAY hey | SAY so what school are you from | SAY im a MY_MAJOR major at MY_SCHOOL what are you studying | SELECT NAME FRIEND_FULL_NAME | PASS
START SAY 1 MY_COMPANY rest MY_COMPANY | SAY i dont have her | SAY this is going to take forever | SAY got her SELECT NAME FRIEND_FULL_NAME	SELECT NAME FRIEND_FULL_NAME | SELECT NAME FRIEND_FULL_NAME | SELECT NAME FRIEND_FULL_NAME | PASS
START | SELECT NAME FRIEND_FULL_NAME | SELECT NAME FRIEND_FULL_NAME | SELECT NAME FRIEND_FULL_NAME	SAY 1 MY_COMPANY rest MY_COMPANY | SAY i dont have her | SAY this is going to take forever | SAY got her SELECT NAME FRIEND_FULL_NAME
START SAY MY_SCHOOL MY_MAJOR MY_COMPANY | SELECT NAME FRIEND_FULL_NAME	SAY do you know FRIEND_FULL_NAME | SELECT NAME FRIEND_FULL_NAME
START | SAY do you know FRIEND_FULL_NAME | SELECT NAME FRIEND_FULL_NAME	SAY MY_SCHOOL MY_MAJOR MY_COMPANY | SELECT NAME FRIEND_FULL_NAME | PASS
START SAY FRIEND_FULL_NAME SAY FRIEND_FULL_NAME SAY martiza | SAY FRIEND_FULL_NAME SAY FRIEND_FULL_NAME | SAY FRIEND_FULL_NAME SAY FRIEND_FULL_NAME SAY FRIEND_FULL_NAME | SAY FRIEND_FULL_NAME SAY FRIEND_FULL_NAME SAY FRIEND_FULL_NAME | SELECT NAME FRIEND_FULL_NAME	SAY 2 MY_COMPANY 1 MY_COMPANY mostly MY_COMPANY | SAY not yet | SELECT NAME FRIEND_FULL_NAME | SAY lawann FRIEND_FULL_NAME FRIEND_FULL_NAME | SELECT NAME FRIEND_FULL_NAME
START | SAY 2 MY_COMPANY 1 MY_COMPANY mostly MY_COMPANY | SAY not yet | SELECT NAME FRIEND_FULL_NAME | SAY lawann FRIEND_FULL_NAME FRIEND_FULL_NAME | SELECT NAME FRIEND_FULL_NAME	SAY FRIEND_FULL_NAME SAY FRIEND_FULL_NAME SAY martiza | SAY FRIEND_FULL_NAME SAY FRIEND_FULL_NAME | SAY FRIEND_FULL_NAME SAY FRIEND_FULL_NAME SAY FRIEND_FULL_NAME | SAY FRIEND_FULL_NAME SAY FRIEND_FULL_NAME SAY FRIEND_FULL_NAME | SELECT NAME FRIEND_FULL_NAME | PASS
START SAY hey | SAY nah never met anyone from there though im real tight with folks from university of MY_SCHOOL | SAY yeah i know two cats from MY_SCHOOL | SAY both work for MY_COMPANY SAY one chick does MY_MAJOR real hard | SAY yeah thats her | SELECT NAME FRIEND_FULL_NAME	SAY hi anybody with MY_SCHOOL of pennselveniya SAY MY_MAJOR or MY_MAJOR | SAY MY_SCHOOL | SAY MY_MAJOR or MY_MAJOR | SAY jessica seaton | SELECT NAME FRIEND_FULL_NAME | PASS
START | SAY hi anybody with MY_SCHOOL of pennselveniya SAY MY_MAJOR or MY_MAJOR | SAY MY_SCHOOL | SAY MY_MAJOR or MY_MAJOR | SAY jessica seaton | SELECT NAME FRIEND_FULL_NAME	SAY hey | SAY nah never met anyone from there though im real tight with folks from university of MY_SCHOOL | SAY yeah i know two cats from MY_SCHOOL | SAY both work for MY_COMPANY SAY one chick does MY_MAJOR real hard | SAY yeah thats her | SELECT NAME FRIEND_FULL_NAME
START SAY hello SAY i have MY_SCHOOL and MY_SCHOOL friends you | SAY none of those | SAY yes | SELECT NAME FRIEND_FULL_NAME	SAY hello do you know anyone who went to ucb SAY ah i know FRIEND_FULL_NAME FRIEND_FULL_NAME and FRIEND_FULL_NAME | SAY FRIEND_FULL_NAME | SELECT NAME FRIEND_FULL_NAME | PASS
START | SAY hello do you know anyone who went to ucb SAY ah i know FRIEND_FULL_NAME FRIEND_FULL_NAME and FRIEND_FULL_NAME | SAY FRIEND_FULL_NAME | SELECT NAME FRIEND_FULL_NAME	SAY hello SAY i have MY_SCHOOL and MY_SCHOOL friends you | SAY none of those | SAY yes | SELECT NAME FRIEND_FULL_NAME
START SAY FRIEND_FULL_NAME SAY FRIEND_FULL_NAME SAY FRIEND_FULL_NAME SAY FRIEND_FULL_NAME | SAY FRIEND_FULL_NAME SAY FRIEND_FULL_NAME SAY FRIEND_FULL_NAME | SELECT NAME FRIEND_FULL_NAME	SAY everyone is at MY_COMPANY except one MY_COMPANY and one MY_COMPANY | SELECT NAME FRIEND_FULL_NAME | PASS
START | SAY everyone is at MY_COMPANY except one MY_COMPANY and one MY_COMPANY | SELECT NAME FRIEND_FULL_NAME	SAY FRIEND_FULL_NAME SAY FRIEND_FULL_NAME SAY FRIEND_FULL_NAME SAY FRIEND_FULL_NAME | SAY FRIEND_FULL_NAME SAY FRIEND_FULL_NAME SAY FRIEND_FULL_NAME | SELECT NAME FRIEND_FULL_NAME
START SAY upenn MY_MAJOR MY_COMPANY | SELECT NAME FRIEND_FULL_NAME	SAY only FRIEND_FULL_NAME works for MY_COMPANY | SELECT NAME FRIEND_FULL_NAME
START | SAY only FRIEND_FULL_NAME works for MY_COMPANY | SELECT NAME FRIEND_FULL_NAME	SAY upenn MY_MAJOR MY_COMPANY | SELECT NAME FRIEND_FULL_NAME | PASS
START SAY test | SAY yes SELECT NAME FRIEND_FULL_NAME	SAY do u know FRIEND_FULL_NAME | SELECT NAME FRIEND_FULL_NAME
START | SAY do u know FRIEND_FULL_NAME | SELECT NAME FRIEND_FULL_NAME	SAY test | SAY yes SELECT NAME FRIEND_FULL_NAME | PASS
START SAY okay that was weird hello person | SAY so lets try and narrow down our friends im from MY_SCHOOL with a mjor in MY_MAJOR | SAY easier thing do you have any friends from MY_SCHOOL or ucal berkely | SAY mk i have one friend from MY_SCHOOL named FRIEND_FULL_NAME | SAY all but one of mine are from MY_COMPANY | SAY yeah hes from berkely SAY emmaunua eliason | SELECT NAME FRIEND_FULL_NAME	SAY hello there | SAY im from u of MY_SCHOOL MY_SCHOOL with a mjor in MY_MAJOR | SAY i have many yeah SAY a lot | SAY how about any from MY_COMPANY | SAY like FRIEND_FULL_NAME | SELECT NAME FRIEND_FULL_NAME | PASS
START | SAY hello there | SAY im from u of MY_SCHOOL MY_SCHOOL with a mjor in MY_MAJOR | SAY i have many yeah SAY a lot | SAY how about any from MY_COMPANY | SAY like FRIEND_FULL_NAME | SELECT NAME FRIEND_FULL_NAME	SAY okay that was weird hello person | SAY so lets try and narrow down our friends im from MY_SCHOOL with a mjor in MY_MAJOR | SAY easier thing do you have any friends from MY_SCHOOL or ucal berkely | SAY mk i have one friend from MY_SCHOOL named FRIEND_FULL_NAME | SAY all but one of mine are from MY_COMPANY | SAY yeah hes from berkely SAY emmaunua eliason | SELECT NAME FRIEND_FULL_NAME
START SAY all MY_COMPANY two from MY_COMPANY | SELECT NAME FRIEND_FULL_NAME	SAY FRIEND_FULL_NAME SAY FRIEND_FULL_NAME SAY FRIEND_FULL_NAME | SELECT NAME FRIEND_FULL_NAME
START | SAY FRIEND_FULL_NAME SAY FRIEND_FULL_NAME SAY FRIEND_FULL_NAME | SELECT NAME FRIEND_FULL_NAME	SAY all MY_COMPANY two from MY_COMPANY | SELECT NAME FRIEND_FULL_NAME | PASS
START SAY only FRIEND_FULL_NAME works for MY_COMPANY | SAY no i do not | SAY no MY_COMPANY and rest are MY_COMPANY | SELECT NAME FRIEND_FULL_NAME	SAY dont know FRIEND_FULL_NAME SAY know anyone from MY_COMPANY | SELECT NAME FRIEND_FULL_NAME SAY MY_COMPANY SAY anyone from MY_COMPANY | SAY FRIEND_FULL_NAME SELECT NAME FRIEND_FULL_NAME | PASS
START | SAY dont know FRIEND_FULL_NAME SAY know anyone from MY_COMPANY | SELECT NAME FRIEND_FULL_NAME SAY MY_COMPANY SAY anyone from MY_COMPANY | SAY FRIEND_FULL_NAME SELECT NAME FRIEND_FULL_NAME	SAY only FRIEND_FULL_NAME works for MY_COMPANY | SAY no i do not | SAY no MY_COMPANY and rest are MY_COMPANY | SELECT NAME FRIEND_FULL_NAME
START SELECT NAME FRIEND_FULL_NAME | SELECT NAME FRIEND_FULL_NAME SAY say names SAY FRIEND_FULL_NAME | SAY FRIEND_FULL_NAME SAY FRIEND_FULL_NAME SELECT NAME FRIEND_FULL_NAME	SAY im at MY_SCHOOL MY_COMPANY studying MY_MAJOR | SAY no | SAY no SELECT NAME FRIEND_FULL_NAME
START | SAY im at MY_SCHOOL MY_COMPANY studying MY_MAJOR | SAY no | SAY no SELECT NAME FRIEND_FULL_NAME	SELECT NAME FRIEND_FULL_NAME | SELECT NAME FRIEND_FULL_NAME SAY say names SAY FRIEND_FULL_NAME | SAY FRIEND_FULL_NAME SAY FRIEND_FULL_NAME SELECT NAME FRIEND_FULL_NAME | PASS
START SAY everyones from MY_COMPANY except 1 MY_COMPANY 1 MY_COMPANY SAY i mean1 MY_COMPANY | SAY nope | SELECT NAME FRIEND_FULL_NAME	SELECT NAME FRIEND_FULL_NAME | SAY gotta be MY_COMPANY then | SELECT NAME FRIEND_FULL_NAME
START | SELECT NAME FRIEND_FULL_NAME | SAY gotta be MY_COMPANY then | SELECT NAME FRIEND_FULL_NAME	SAY everyones from MY_COMPANY except 1 MY_COMPANY 1 MY_COMPANY SAY i mean1 MY_COMPANY | SAY nope | SELECT NAME FRIEND_FULL_NAME | PASS
START SAY hi SAY stanfordeconuber here | SELECT NAME FRIEND_FULL_NAME	SELECT NAME FRIEND_FULL_NAME | PASS
START | SELECT NAME FRIEND_FULL_NAME	SAY hi SAY stanfordeconuber here | SELECT NAME FRIEND_FULL_NAME
START SAY one MY_COMPANY FRIEND_FULL_NAME | SELECT NAME FRIEND_FULL_NAME	SAY yup SELECT NAME FRIEND_FULL_NAME | PASS
START | SAY yup SELECT NAME FRIEND_FULL_NAME	SAY one MY_COMPANY FRIEND_FULL_NAME | SELECT NAME FRIEND_FULL_NAME
START SAY all at MY_COMPANY | SAY nope | SAY do you have any friends working at MY_COMPANY SELECT NAME FRIEND_FULL_NAME	SELECT NAME FRIEND_FULL_NAME | SELECT NAME FRIEND_FULL_NAME | PASS
START | SELECT NAME FRIEND_FULL_NAME | SELECT NAME FRIEND_FULL_NAME	SAY all at MY_COMPANY | SAY nope | SAY do you have any friends working at MY_COMPANY SELECT NAME FRIEND_FULL_NAME
START SAY everyone works at MY_COMPANY | SAY MY_SCHOOL SAY barber or FRIEND_FULL_NAME | SAY who is our mutual friend SAY FRIEND_FULL_NAME | SAY FRIEND_FULL_NAME | SELECT NAME FRIEND_FULL_NAME	SAY ha everyone i can see works at MY_COMPANY almost so what school did you go to | SAY i went to MY_SCHOOL what was your major | SAY i dont know i dont know how to figure this out | SAY FRIEND_FULL_NAME SELECT NAME FRIEND_FULL_NAME | PASS
START | SAY ha everyone i can see works at MY_COMPANY almost so what school did you go to | SAY i went to MY_SCHOOL what was your major | SAY i dont know i dont know how to figure this out | SAY FRIEND_FULL_NAME SELECT NAME FRIEND_FULL_NAME	SAY everyone works at MY_COMPANY | SAY MY_SCHOOL SAY barber or FRIEND_FULL_NAME | SAY who is our mutual friend SAY FRIEND_FULL_NAME | SAY FRIEND_FULL_NAME | SELECT NAME FRIEND_FULL_NAME
START SAY hey SAY MY_SCHOOL | SAY MY_MAJOR SAY MY_COMPANY | SAY FRIEND_FULL_NAME | SAY FRIEND_FULL_NAME SAY FRIEND_FULL_NAME SAY or SAY FRIEND_FULL_NAME SAY got it | SELECT NAME FRIEND_FULL_NAME	SAY where do u work | SAY MY_SCHOOL MY_MAJOR MY_COMPANY | SAY dont got it SAY FRIEND_FULL_NAME | SELECT NAME FRIEND_FULL_NAME | PASS
START | SAY where do u work | SAY MY_SCHOOL MY_MAJOR MY_COMPANY | SAY dont got it SAY FRIEND_FULL_NAME | SELECT NAME FRIEND_FULL_NAME	SAY hey SAY MY_SCHOOL | SAY MY_MAJOR SAY MY_COMPANY | SAY FRIEND_FULL_NAME | SAY FRIEND_FULL_NAME SAY FRIEND_FULL_NAME SAY or SAY FRIEND_FULL_NAME SAY got it | SELECT NAME FRIEND_FULL_NAME
START SAY one friend from MY_COMPANY FRIEND_FULL_NAME | SAY rest are MY_COMPANY SELECT NAME FRIEND_FULL_NAME	SAY only FRIEND_FULL_NAME from facbook | SELECT NAME FRIEND_FULL_NAME
START | SAY only FRIEND_FULL_NAME from facbook | SELECT NAME FRIEND_FULL_NAME	SAY one friend from MY_COMPANY FRIEND_FULL_NAME | SAY rest are MY_COMPANY SELECT NAME FRIEND_FULL_NAME | PASS
START SAY ucb MY_MAJOR MY_COMPANY | SAY no MY_COMPANY friends | SAY FRIEND_FULL_NAME | SAY whos the MY_COMPANY one | SAY no | SAY yes SELECT NAME FRIEND_FULL_NAME	SAY all my friends work at MY_COMPANY | SAY except for one MY_COMPANY | SAY one MY_COMPANY | SAY nope SAY one MY_COMPANY SAY FRIEND_FULL_NAME | SAY or FRIEND_FULL_NAME SAY FRIEND_FULL_NAME | SELECT NAME FRIEND_FULL_NAME
START | SAY all my friends work at MY_COMPANY | SAY except for one MY_COMPANY | SAY one MY_COMPANY | SAY nope SAY one MY_COMPANY SAY FRIEND_FULL_NAME | SAY or FRIEND_FULL_NAME SAY FRIEND_FULL_NAME | SELECT NAME FRIEND_FULL_NAME	SAY ucb MY_MAJOR MY_COMPANY | SAY no MY_COMPANY friends | SAY FRIEND_FULL_NAME | SAY whos the MY_COMPANY one | SAY no | SAY yes SELECT NAME FRIEND_FULL_NAME | PASS
START SAY hi SAY know anyone at MY_COMPANY | SELECT NAME FRIEND_FULL_NAME	SELECT NAME FRIEND_FULL_NAME SAY all the others work at MY_COMPANY and one at MY_COMPANY | PASS
START | SELECT NAME FRIEND_FULL_NAME SAY all the others work at MY_COMPANY and one at MY_COMPANY	SAY hi SAY know anyone at MY_COMPANY | SELECT NAME FRIEND_FULL_NAME
START SAY any friends at MY_COMPANY | SAY MY_COMPANY yes SAY went to upenn | SELECT NAME FRIEND_FULL_NAME	SAY no SAY MY_COMPANY or MY_COMPANY | SAY FRIEND_FULL_NAME | SELECT NAME FRIEND_FULL_NAME
START | SAY no SAY MY_COMPANY or MY_COMPANY | SAY FRIEND_FULL_NAME | SELECT NAME FRIEND_FULL_NAME	SAY any friends at MY_COMPANY | SAY MY_COMPANY yes SAY went to upenn | SELECT NAME FRIEND_FULL_NAME | PASS
START SAY mostly fb SAY one MY_COMPANY one MY_COMPANY one MY_COMPANY SAY mostly MY_SCHOOL | SAY no SELECT NAME FRIEND_FULL_NAME | SAY FRIEND_FULL_NAME SELECT NAME FRIEND_FULL_NAME	SAY lilia mikel | SAY anyone from MY_COMPANY | SELECT NAME FRIEND_FULL_NAME
START | SAY lilia mikel | SAY anyone from MY_COMPANY | SELECT NAME FRIEND_FULL_NAME	SAY mostly fb SAY one MY_COMPANY one MY_COMPANY one MY_COMPANY SAY mostly MY_SCHOOL | SAY no SELECT NAME FRIEND_FULL_NAME | SAY FRIEND_FULL_NAME SELECT NAME FRIEND_FULL_NAME | PASS
START SAY what school do you go to | SAY what is your major | SAY what company do you work for | SAY same SAY and MY_SCHOOL SAY FRIEND_FULL_NAME | SAY no | SELECT NAME FRIEND_FULL_NAME	SAY MY_SCHOOL | SAY MY_MAJOR SAY MY_COMPANY | SAY got friends in MY_SCHOOL uc university of berkley SAY also MY_SCHOOL | SAY FRIEND_FULL_NAME nicks | SAY yep FRIEND_FULL_NAME | SELECT NAME FRIEND_FULL_NAME
START | SAY MY_SCHOOL | SAY MY_MAJOR SAY MY_COMPANY | SAY got friends in MY_SCHOOL uc university of berkley SAY also MY_SCHOOL | SAY FRIEND_FULL_NAME nicks | SAY yep FRIEND_FULL_NAME | SELECT NAME FRIEND_FULL_NAME	SAY what school do you go to | SAY what is your major | SAY what company do you work for | SAY same SAY and MY_SCHOOL SAY FRIEND_FULL_NAME | SAY no | SELECT NAME FRIEND_FULL_NAME | PASS
START SAY hi | SAY know any from MY_COMPANY | SELECT NAME FRIEND_FULL_NAME	SAY mostly they are from fb SAY hi | SELECT NAME FRIEND_FULL_NAME SAY thats it | PASS
START | SAY mostly they are from fb SAY hi | SELECT NAME FRIEND_FULL_NAME SAY thats it	SAY hi | SAY know any from MY_COMPANY | SELECT NAME FRIEND_FULL_NAME
START SAY any friends MY_SCHOOL MY_COMPANY | SAY MY_SCHOOL MY_COMPANY SAY none at MY_COMPANY | SELECT NAME FRIEND_FULL_NAME	SAY no SAY MY_SCHOOL MY_COMPANY | SAY no only one friend at MY_COMPANY and they went to MY_SCHOOL SAY the rest are at MY_COMPANY | SELECT NAME FRIEND_FULL_NAME
START | SAY no SAY MY_SCHOOL MY_COMPANY | SAY no only one friend at MY_COMPANY and they went to MY_SCHOOL SAY the rest are at MY_COMPANY | SELECT NAME FRIEND_FULL_NAME	SAY any friends MY_SCHOOL MY_COMPANY | SAY MY_SCHOOL MY_COMPANY SAY none at MY_COMPANY | SELECT NAME FRIEND_FULL_NAME | PASS
START SAY MY_SCHOOL MY_MAJOR MY_COMPANY | SAY do you know FRIEND_FULL_NAME | SELECT NAME FRIEND_FULL_NAME	SAY i my name is jose i work at MY_COMPANY and majore din MY_MAJOR | SELECT NAME FRIEND_FULL_NAME | PASS
START | SAY i my name is jose i work at MY_COMPANY and majore din MY_MAJOR | SELECT NAME FRIEND_FULL_NAME	SAY MY_SCHOOL MY_MAJOR MY_COMPANY | SAY do you know FRIEND_FULL_NAME | SELECT NAME FRIEND_FULL_NAME
START SAY hi SAY know anyone at MY_COMPANY | SELECT NAME FRIEND_FULL_NAME	SAY only FRIEND_FULL_NAME | SELECT NAME FRIEND_FULL_NAME
START | SAY only FRIEND_FULL_NAME | SELECT NAME FRIEND_FULL_NAME	SAY hi SAY know anyone at MY_COMPANY | SELECT NAME FRIEND_FULL_NAME | PASS
START SAY all of mine are MY_COMPANY any at MY_SCHOOL | SELECT NAME FRIEND_FULL_NAME	SAY has to be FRIEND_FULL_NAME or FRIEND_FULL_NAME | SELECT NAME FRIEND_FULL_NAME
START | SAY has to be FRIEND_FULL_NAME or FRIEND_FULL_NAME | SELECT NAME FRIEND_FULL_NAME	SAY all of mine are MY_COMPANY any at MY_SCHOOL | SELECT NAME FRIEND_FULL_NAME | PASS
START SAY hi SAY do you know FRIEND_FULL_NAME | SAY no SAY anyone at MY_COMPANY | SAY MY_COMPANY | SELECT NAME FRIEND_FULL_NAME	SAY MY_MAJOR SAY FRIEND_FULL_NAME SAY FRIEND_FULL_NAME SAY lilia | SAY no SAY MY_COMPANY | SAY FRIEND_FULL_NAME | SELECT NAME FRIEND_FULL_NAME
START | SAY MY_MAJOR SAY FRIEND_FULL_NAME SAY FRIEND_FULL_NAME SAY lilia | SAY no SAY MY_COMPANY | SAY FRIEND_FULL_NAME | SELECT NAME FRIEND_FULL_NAME	SAY hi SAY do you know FRIEND_FULL_NAME | SAY no SAY anyone at MY_COMPANY | SAY MY_COMPANY | SELECT NAME FRIEND_FULL_NAME | PASS
START SAY ucb MY_MAJOR MY_COMPANY SAY do you work at MY_COMPANY | SAY do you know FRIEND_FULL_NAME SELECT NAME FRIEND_FULL_NAME	SAY alll my friends are at MY_COMPANY one at MY_COMPANY | SELECT NAME FRIEND_FULL_NAME
START | SAY alll my friends are at MY_COMPANY one at MY_COMPANY | SELECT NAME FRIEND_FULL_NAME	SAY ucb MY_MAJOR MY_COMPANY SAY do you work at MY_COMPANY | SAY do you know FRIEND_FULL_NAME SELECT NAME FRIEND_FULL_NAME | PASS
START SAY all my friends are from MY_COMPANY | SELECT NAME FRIEND_FULL_NAME	SELECT NAME FRIEND_FULL_NAME | PASS
START | SELECT NAME FRIEND_FULL_NAME	SAY all my friends are from MY_COMPANY | SELECT NAME FRIEND_FULL_NAME
START SAY all friends work at MY_COMPANY one works at MY_COMPANY FRIEND_FULL_NAME | SELECT NAME FRIEND_FULL_NAME	SAY FRIEND_FULL_NAME | SELECT NAME FRIEND_FULL_NAME
START | SAY FRIEND_FULL_NAME | SELECT NAME FRIEND_FULL_NAME	SAY all friends work at MY_COMPANY one works at MY_COMPANY FRIEND_FULL_NAME | SELECT NAME FRIEND_FULL_NAME | PASS
START SAY FRIEND_FULL_NAME | SAY FRIEND_FULL_NAME | SAY FRIEND_FULL_NAME SELECT NAME FRIEND_FULL_NAME	SAY one MY_COMPANY FRIEND_FULL_NAME | SELECT NAME FRIEND_FULL_NAME | PASS
START | SAY one MY_COMPANY FRIEND_FULL_NAME | SELECT NAME FRIEND_FULL_NAME	SAY FRIEND_FULL_NAME | SAY FRIEND_FULL_NAME | SAY FRIEND_FULL_NAME SELECT NAME FRIEND_FULL_NAME
START SAY hello | SAY do you know FRIEND_FULL_NAME | SAY FRIEND_FULL_NAME | SELECT NAME FRIEND_FULL_NAME	SAY hi | SAY three MY_COMPANY friends rest are MY_COMPANY SAY yes actually | SELECT NAME FRIEND_FULL_NAME | PASS
START | SAY hi | SAY three MY_COMPANY friends rest are MY_COMPANY SAY yes actually | SELECT NAME FRIEND_FULL_NAME	SAY hello | SAY do you know FRIEND_FULL_NAME | SAY FRIEND_FULL_NAME | SELECT NAME FRIEND_FULL_NAME
START SAY hi SAY my major linquistics | SAY company MY_COMPANY | SAY hi | SELECT NAME FRIEND_FULL_NAME	SAY mine is MY_MAJOR | SAY i work for MY_COMPANY SAY FRIEND_FULL_NAME SAY katheleen brough SAY lillie mikel SAY FRIEND_FULL_NAME SAY FRIEND_FULL_NAME SAY FRIEND_FULL_NAME SAY FRIEND_FULL_NAME | SAY FRIEND_FULL_NAME SAY FRIEND_FULL_NAME SAY FRIEND_FULL_NAME SAY are you friends with one of those people | SELECT NAME FRIEND_FULL_NAME
START | SAY mine is MY_MAJOR | SAY i work for MY_COMPANY SAY FRIEND_FULL_NAME SAY katheleen brough SAY lillie mikel SAY FRIEND_FULL_NAME SAY FRIEND_FULL_NAME SAY FRIEND_FULL_NAME SAY FRIEND_FULL_NAME | SAY FRIEND_FULL_NAME SAY FRIEND_FULL_NAME SAY FRIEND_FULL_NAME SAY are you friends with one of those people | SELECT NAME FRIEND_FULL_NAME	SAY hi SAY my major linquistics | SAY company MY_COMPANY | SAY hi | SELECT NAME FRIEND_FULL_NAME | PASS
START SAY FRIEND_FULL_NAME from MY_COMPANY or FRIEND_FULL_NAME or FRIEND_FULL_NAME from MY_COMPANY | SAY rest of my friends are from MY_COMPANY SELECT NAME FRIEND_FULL_NAME	SAY do you have any friend working for MY_COMPANY | SELECT NAME FRIEND_FULL_NAME
START | SAY do you have any friend working for MY_COMPANY | SELECT NAME FRIEND_FULL_NAME	SAY FRIEND_FULL_NAME from MY_COMPANY or FRIEND_FULL_NAME or FRIEND_FULL_NAME from MY_COMPANY | SAY rest of my friends are from MY_COMPANY SELECT NAME FRIEND_FULL_NAME | PASS
START SAY hello | SAY FRIEND_FULL_NAME | SAY FRIEND_FULL_NAME SAY or FRIEND_FULL_NAME | SAY me too SAY SELECT NAME FRIEND_FULL_NAME	SAY hey | SAY most of my friends work at MY_COMPANY it seems | SAY no i dont have FRIEND_FULL_NAME or FRIEND_FULL_NAME SAY i have a FRIEND_FULL_NAME | SELECT NAME FRIEND_FULL_NAME
START | SAY hey | SAY most of my friends work at MY_COMPANY it seems | SAY no i dont have FRIEND_FULL_NAME or FRIEND_FULL_NAME SAY i have a FRIEND_FULL_NAME | SELECT NAME FRIEND_FULL_NAME	SAY hello | SAY FRIEND_FULL_NAME | SAY FRIEND_FULL_NAME SAY or FRIEND_FULL_NAME | SAY me too SAY SELECT NAME FRIEND_FULL_NAME | PASS
START SAY all mine work for MY_COMPANY | SAY any from MY_SCHOOL | SELECT NAME FRIEND_FULL_NAME | SAY mantz | SAY heid SELECT NAME FRIEND_FULL_NAME	SAY mine are mixed | SAY my major is econonmics | SAY i have 2 from MY_SCHOOL | SAY no SAY i have 2 MY_COMPANY SAY mars and heid | SELECT NAME FRIEND_FULL_NAME
START | SAY mine are mixed | SAY my major is econonmics | SAY i have 2 from MY_SCHOOL | SAY no SAY i have 2 MY_COMPANY SAY mars and heid | SELECT NAME FRIEND_FULL_NAME	SAY all mine work for MY_COMPANY | SAY any from MY_SCHOOL | SELECT NAME FRIEND_FULL_NAME | SAY mantz | SAY heid SELECT NAME FRIEND_FULL_NAME | PASS
START SAY whats your school | SAY company | SAY MY_MAJOR | SAY my company is MY_COMPANY SAY school is university of californiaberkeley SAY hmm | SAY is it FRIEND_FULL_NAME SAY she majored in MY_MAJOR at my school and works at MY_COMPANY | SELECT NAME FRIEND_FULL_NAME	SAY MY_SCHOOL | SAY what did you major in SAY MY_COMPANY | SAY MY_MAJOR here | SAY wow difficult | SAY lets try that | SELECT NAME FRIEND_FULL_NAME
START | SAY MY_SCHOOL | SAY what did you major in SAY MY_COMPANY | SAY MY_MAJOR here | SAY wow difficult | SAY lets try that | SELECT NAME FRIEND_FULL_NAME	SAY whats your school | SAY company | SAY MY_MAJOR | SAY my company is MY_COMPANY SAY school is university of californiaberkeley SAY hmm | SAY is it FRIEND_FULL_NAME SAY she majored in MY_MAJOR at my school and works at MY_COMPANY | SELECT NAME FRIEND_FULL_NAME | PASS
START SAY i go to MY_SCHOOL and im a MY_MAJOR major what about you | SELECT NAME FRIEND_FULL_NAME | SAY mine is MY_COMPANY | SELECT NAME FRIEND_FULL_NAME	SAY i go to MY_SCHOOL and have a MY_MAJOR major | SAY company is MY_COMPANY | SELECT NAME FRIEND_FULL_NAME | PASS
START | SAY i go to MY_SCHOOL and have a MY_MAJOR major | SAY company is MY_COMPANY | SELECT NAME FRIEND_FULL_NAME	SAY i go to MY_SCHOOL and im a MY_MAJOR major what about you | SELECT NAME FRIEND_FULL_NAME | SAY mine is MY_COMPANY | SELECT NAME FRIEND_FULL_NAME
START SAY do you have FRIEND_FULL_NAME FRIEND_FULL_NAME FRIEND_FULL_NAME FRIEND_FULL_NAME | SELECT NAME FRIEND_FULL_NAME	SAY FRIEND_FULL_NAME | SELECT NAME FRIEND_FULL_NAME
START | SAY FRIEND_FULL_NAME | SELECT NAME FRIEND_FULL_NAME	SAY do you have FRIEND_FULL_NAME FRIEND_FULL_NAME FRIEND_FULL_NAME FRIEND_FULL_NAME | SELECT NAME FRIEND_FULL_NAME | PASS
START SAY i went to MY_SCHOOL as an MY_MAJOR major i work for MY_COMPANY | SAY nope | SAY yep SELECT NAME FRIEND_FULL_NAME	SAY FRIEND_FULL_NAME | SAY FRIEND_FULL_NAME | SELECT NAME FRIEND_FULL_NAME
START | SAY FRIEND_FULL_NAME | SAY FRIEND_FULL_NAME | SELECT NAME FRIEND_FULL_NAME	SAY i went to MY_SCHOOL as an MY_MAJOR major i work for MY_COMPANY | SAY nope | SAY yep SELECT NAME FRIEND_FULL_NAME | PASS
START SAY MY_COMPANY | SAY standford SAY no MY_COMPANY | SAY MY_SCHOOL SAY MY_COMPANY or MY_COMPANY | SAY FRIEND_FULL_NAME | SELECT NAME FRIEND_FULL_NAME	SAY hmm SAY no SAY MY_COMPANY | SAY no standford SAY MY_COMPANY | SAY MY_COMPANY SAY nathan SAY | SELECT NAME FRIEND_FULL_NAME | PASS
START | SAY hmm SAY no SAY MY_COMPANY | SAY no standford SAY MY_COMPANY | SAY MY_COMPANY SAY nathan SAY | SELECT NAME FRIEND_FULL_NAME	SAY MY_COMPANY | SAY standford SAY no MY_COMPANY | SAY MY_SCHOOL SAY MY_COMPANY or MY_COMPANY | SAY FRIEND_FULL_NAME | SELECT NAME FRIEND_FULL_NAME
START SAY hi i have MY_SCHOOL MY_MAJOR MY_COMPANY | SAY i have one MY_COMPANY and one MY_COMPANY | SELECT NAME FRIEND_FULL_NAME	SAY i have no one from MY_SCHOOL | SAY actually wait i know elen prouty of FRIEND_FULL_NAME SAY from MY_SCHOOL | SELECT NAME FRIEND_FULL_NAME
START | SAY i have no one from MY_SCHOOL | SAY actually wait i know elen prouty of FRIEND_FULL_NAME SAY from MY_SCHOOL | SELECT NAME FRIEND_FULL_NAME	SAY hi i have MY_SCHOOL MY_MAJOR MY_COMPANY | SAY i have one MY_COMPANY and one MY_COMPANY | SELECT NAME FRIEND_FULL_NAME | PASS
START SAY hello i work for MY_COMPANY and i went to MY_SCHOOL and majored in MY_MAJOR | SAY what about you | SAY where did you go to college | SELECT NAME FRIEND_FULL_NAME	SAY hey whats up | SAY i work for MY_COMPANY | SAY went to berkley studied MY_MAJOR | SELECT NAME FRIEND_FULL_NAME
START | SAY hey whats up | SAY i work for MY_COMPANY | SAY went to berkley studied MY_MAJOR | SELECT NAME FRIEND_FULL_NAME	SAY hello i work for MY_COMPANY and i went to MY_SCHOOL and majored in MY_MAJOR | SAY what about you | SAY where did you go to college | SELECT NAME FRIEND_FULL_NAME | PASS
START SAY hey SAY i went to MY_SCHOOL for MY_MAJOR work at MY_COMPANY SAY you | SAY FRIEND_FULL_NAME | SELECT NAME FRIEND_FULL_NAME	SAY hey SAY MY_SCHOOL work at MY_COMPANY SAY majored in MY_MAJOR | SAY yes | SELECT NAME FRIEND_FULL_NAME
START | SAY hey SAY MY_SCHOOL work at MY_COMPANY SAY majored in MY_MAJOR | SAY yes | SELECT NAME FRIEND_FULL_NAME	SAY hey SAY i went to MY_SCHOOL for MY_MAJOR work at MY_COMPANY SAY you | SAY FRIEND_FULL_NAME | SELECT NAME FRIEND_FULL_NAME | PASS
START SAY any friends at MY_COMPANY | SELECT NAME FRIEND_FULL_NAME SAY the rest of mine are MY_COMPANY SAY what school did you go to | SELECT NAME FRIEND_FULL_NAME | SAY MY_SCHOOL SELECT NAME FRIEND_FULL_NAME | SELECT NAME FRIEND_FULL_NAME SAY MY_MAJOR | SELECT NAME FRIEND_FULL_NAME	SAY yes | SAY MY_SCHOOL | SAY you | SAY major | SELECT NAME FRIEND_FULL_NAME | PASS
START | SAY yes | SAY MY_SCHOOL | SAY you | SAY major | SELECT NAME FRIEND_FULL_NAME	SAY any friends at MY_COMPANY | SELECT NAME FRIEND_FULL_NAME SAY the rest of mine are MY_COMPANY SAY what school did you go to | SELECT NAME FRIEND_FULL_NAME | SAY MY_SCHOOL SELECT NAME FRIEND_FULL_NAME | SELECT NAME FRIEND_FULL_NAME SAY MY_MAJOR | SELECT NAME FRIEND_FULL_NAME
START SAY hey i went o MY_SCHOOL majored in MY_MAJOR and work at MY_COMPANY you | SAY do you know FRIEND_FULL_NAME | SELECT NAME FRIEND_FULL_NAME	SAY i went to MY_SCHOOL and majord in MY_MAJOR and work at MY_COMPANY | SAY yes | SELECT NAME FRIEND_FULL_NAME
START | SAY i went to MY_SCHOOL and majord in MY_MAJOR and work at MY_COMPANY | SAY yes | SELECT NAME FRIEND_FULL_NAME	SAY hey i went o MY_SCHOOL majored in MY_MAJOR and work at MY_COMPANY you | SAY do you know FRIEND_FULL_NAME | SELECT NAME FRIEND_FULL_NAME | PASS
START SAY hi | SAY FRIEND_FULL_NAME | SAY shes not on this list | SAY what major | SAY theyre not on this list so be more specific | SELECT NAME FRIEND_FULL_NAME SAY FRIEND_FULL_NAME is there	SAY you know MY_SCHOOL SAY FRIEND_FULL_NAME FRIEND_FULL_NAME SAY or u of pa | SAY FRIEND_FULL_NAME | SAY ok SAY FRIEND_FULL_NAME FRIEND_FULL_NAME FRIEND_FULL_NAME FRIEND_FULL_NAME FRIEND_FULL_NAME | SAY thanhkendricksusannaaline | SAY those are all my names SAY you have to have one of them | SELECT NAME FRIEND_FULL_NAME
START | SAY you know MY_SCHOOL SAY FRIEND_FULL_NAME FRIEND_FULL_NAME SAY or u of pa | SAY FRIEND_FULL_NAME | SAY ok SAY FRIEND_FULL_NAME FRIEND_FULL_NAME FRIEND_FULL_NAME FRIEND_FULL_NAME FRIEND_FULL_NAME | SAY thanhkendricksusannaaline | SAY those are all my names SAY you have to have one of them | SELECT NAME FRIEND_FULL_NAME	SAY hi | SAY FRIEND_FULL_NAME | SAY shes not on this list | SAY what major | SAY theyre not on this list so be more specific | SELECT NAME FRIEND_FULL_NAME SAY FRIEND_FULL_NAME is there | PASS
START SAY MY_MAJOR | SAY MY_MAJOR | SAY FRIEND_FULL_NAME debert FRIEND_FULL_NAME | SAY FRIEND_FULL_NAME debert | SAY no MY_COMPANY only MY_COMPANY | SELECT NAME FRIEND_FULL_NAME	SAY no | SAY no MY_MAJOR SAY MY_SCHOOL | SAY no MY_SCHOOL | SAY no works at MY_COMPANY | SAY i was looking at my info SAY sorry SAY FRIEND_FULL_NAME | SELECT NAME FRIEND_FULL_NAME
START | SAY no | SAY no MY_MAJOR SAY MY_SCHOOL | SAY no MY_SCHOOL | SAY no works at MY_COMPANY | SAY i was looking at my info SAY sorry SAY FRIEND_FULL_NAME | SELECT NAME FRIEND_FULL_NAME	SAY MY_MAJOR | SAY MY_MAJOR | SAY FRIEND_FULL_NAME debert FRIEND_FULL_NAME | SAY FRIEND_FULL_NAME debert | SAY no MY_COMPANY only MY_COMPANY | SELECT NAME FRIEND_FULL_NAME | PASS
START SAY hey | SAY i went to MY_SCHOOL for MY_MAJOR i work at MY_COMPANY SAY you | SAY FRIEND_FULL_NAME | SELECT NAME FRIEND_FULL_NAME	SAY hi | SAY i went to u of MY_SCHOOL MY_MAJOR at MY_COMPANY | SAY yeah emanuel eliason | SELECT NAME FRIEND_FULL_NAME
START | SAY hi | SAY i went to u of MY_SCHOOL MY_MAJOR at MY_COMPANY | SAY yeah emanuel eliason | SELECT NAME FRIEND_FULL_NAME	SAY hey | SAY i went to MY_SCHOOL for MY_MAJOR i work at MY_COMPANY SAY you | SAY FRIEND_FULL_NAME | SELECT NAME FRIEND_FULL_NAME | PASS
START SAY FRIEND_FULL_NAME FRIEND_FULL_NAME FRIEND_FULL_NAME FRIEND_FULL_NAME FRIEND_FULL_NAME | SAY FRIEND_FULL_NAME FRIEND_FULL_NAME FRIEND_FULL_NAME FRIEND_FULL_NAME FRIEND_FULL_NAME SAY hello | SAY any names that i listed match your list | SAY keep going | SAY no SAY another | SELECT NAME FRIEND_FULL_NAME	SAY sup | SAY imnew to this | SAY no SAY FRIEND_FULL_NAME SAY FRIEND_FULL_NAME SAY FRIEND_FULL_NAME SAY FRIEND_FULL_NAME | SAY wait SAY FRIEND_FULL_NAME | SAY FRIEND_FULL_NAME SAY FRIEND_FULL_NAME SAY FRIEND_FULL_NAME SAY FRIEND_FULL_NAME | SAY FRIEND_FULL_NAME SELECT NAME FRIEND_FULL_NAME
START | SAY sup | SAY imnew to this | SAY no SAY FRIEND_FULL_NAME SAY FRIEND_FULL_NAME SAY FRIEND_FULL_NAME SAY FRIEND_FULL_NAME | SAY wait SAY FRIEND_FULL_NAME | SAY FRIEND_FULL_NAME SAY FRIEND_FULL_NAME SAY FRIEND_FULL_NAME SAY FRIEND_FULL_NAME | SAY FRIEND_FULL_NAME SELECT NAME FRIEND_FULL_NAME	SAY FRIEND_FULL_NAME FRIEND_FULL_NAME FRIEND_FULL_NAME FRIEND_FULL_NAME FRIEND_FULL_NAME | SAY FRIEND_FULL_NAME FRIEND_FULL_NAME FRIEND_FULL_NAME FRIEND_FULL_NAME FRIEND_FULL_NAME SAY hello | SAY any names that i listed match your list | SAY keep going | SAY no SAY another | SELECT NAME FRIEND_FULL_NAME | PASS
START SAY testing | SAY ok SAY match names | SAY FRIEND_FULL_NAME SAY FRIEND_FULL_NAME SAY FRIEND_FULL_NAME SAY FRIEND_FULL_NAME | SELECT NAME FRIEND_FULL_NAME	SAY hell SAY hello | SAY yeah | SAY SELECT NAME FRIEND_FULL_NAME | PASS
START | SAY hell SAY hello | SAY yeah | SAY SELECT NAME FRIEND_FULL_NAME	SAY testing | SAY ok SAY match names | SAY FRIEND_FULL_NAME SAY FRIEND_FULL_NAME SAY FRIEND_FULL_NAME SAY FRIEND_FULL_NAME | SELECT NAME FRIEND_FULL_NAME
START SAY yo you here | SAY word are we supposed to just look and compare names or SAY doesnt seem like a puzzle | SAY do you have a friend from MY_SCHOOL | SAY no i go to MY_SCHOOL SAY where do you go | SAY i do not SAY nope | SAY do you know FRIEND_FULL_NAME | SAY or FRIEND_FULL_NAME SAY or FRIEND_FULL_NAME | SAY okay weve done it | SELECT NAME FRIEND_FULL_NAME	SAY hey yea just reading | SAY yea ask questions till we find someone we both know | SAY have you gone to university of MY_SCHOOL MY_SCHOOL SAY i do not | SAY you might know FRIEND_FULL_NAME SAY or FRIEND_FULL_NAME | SAY i go to university of MY_SCHOOL | SAY i do not | SAY i do know FRIEND_FULL_NAME | SELECT NAME FRIEND_FULL_NAME | PASS
START | SAY hey yea just reading | SAY yea ask questions till we find someone we both know | SAY have you gone to university of MY_SCHOOL MY_SCHOOL SAY i do not | SAY you might know FRIEND_FULL_NAME SAY or FRIEND_FULL_NAME | SAY i go to university of MY_SCHOOL | SAY i do not | SAY i do know FRIEND_FULL_NAME | SELECT NAME FRIEND_FULL_NAME	SAY yo you here | SAY word are we supposed to just look and compare names or SAY doesnt seem like a puzzle | SAY do you have a friend from MY_SCHOOL | SAY no i go to MY_SCHOOL SAY where do you go | SAY i do not SAY nope | SAY do you know FRIEND_FULL_NAME | SAY or FRIEND_FULL_NAME SAY or FRIEND_FULL_NAME | SAY okay weve done it | SELECT NAME FRIEND_FULL_NAME
START SAY do you have friends majoring in MY_MAJOR | SAY i know hanby SELECT NAME FRIEND_FULL_NAME	SAY here is my list of friends pick name that you also have as i type them one will match SAY bateman SAY brunette SAY prouty SAY allhouse SAY hanby SAY FRIEND_FULL_NAME SAY pettaway SAY bjornson SAY roker SAY dagley | SELECT NAME FRIEND_FULL_NAME
START | SAY here is my list of friends pick name that you also have as i type them one will match SAY bateman SAY brunette SAY prouty SAY allhouse SAY hanby SAY FRIEND_FULL_NAME SAY pettaway SAY bjornson SAY roker SAY dagley | SELECT NAME FRIEND_FULL_NAME	SAY do you have friends majoring in MY_MAJOR | SAY i know hanby SELECT NAME FRIEND_FULL_NAME | PASS
START SAY how it going SAY i went to MY_SCHOOL and majored in MY_MAJOR how about you | SAY i work for MY_COMPANY u SAY no not FRIEND_FULL_NAME | SAY oops sorry yes FRIEND_FULL_NAME SELECT NAME FRIEND_FULL_NAME	SAY i went to university of MY_SCHOOL berkley and majored in MY_MAJOR SAY are you FRIEND_FULL_NAME | SAY i work for MY_COMPANY | SELECT NAME FRIEND_FULL_NAME
START | SAY i went to university of MY_SCHOOL berkley and majored in MY_MAJOR SAY are you FRIEND_FULL_NAME | SAY i work for MY_COMPANY | SELECT NAME FRIEND_FULL_NAME	SAY how it going SAY i went to MY_SCHOOL and majored in MY_MAJOR how about you | SAY i work for MY_COMPANY u SAY no not FRIEND_FULL_NAME | SAY oops sorry yes FRIEND_FULL_NAME SELECT NAME FRIEND_FULL_NAME | PASS
START SAY i went to u of MY_SCHOOL and work for MY_COMPANY | SAY no where did you go to school work | SAY yes i know FRIEND_FULL_NAME thats the answer | SELECT NAME FRIEND_FULL_NAME	SAY are you FRIEND_FULL_NAME | SAY i went to MY_SCHOOL and work for MY_COMPANY SAY are you FRIEND_FULL_NAME | SELECT NAME FRIEND_FULL_NAME | PASS
START | SAY are you FRIEND_FULL_NAME | SAY i went to MY_SCHOOL and work for MY_COMPANY SAY are you FRIEND_FULL_NAME | SELECT NAME FRIEND_FULL_NAME	SAY i went to u of MY_SCHOOL and work for MY_COMPANY | SAY no where did you go to school work | SAY yes i know FRIEND_FULL_NAME thats the answer | SELECT NAME FRIEND_FULL_NAME
START SAY FRIEND_FULL_NAME FRIEND_FULL_NAME FRIEND_FULL_NAME FRIEND_FULL_NAME | SAY FRIEND_FULL_NAME marlyn FRIEND_FULL_NAME FRIEND_FULL_NAME SELECT NAME FRIEND_FULL_NAME	SAY all mine work at MY_COMPANY SAY FRIEND_FULL_NAME SELECT NAME FRIEND_FULL_NAME | PASS
START | SAY all mine work at MY_COMPANY SAY FRIEND_FULL_NAME SELECT NAME FRIEND_FULL_NAME	SAY FRIEND_FULL_NAME FRIEND_FULL_NAME FRIEND_FULL_NAME FRIEND_FULL_NAME | SAY FRIEND_FULL_NAME marlyn FRIEND_FULL_NAME FRIEND_FULL_NAME SELECT NAME FRIEND_FULL_NAME
START SAY any friends at MY_COMPANY or MY_COMPANY SELECT NAME FRIEND_FULL_NAME | SELECT NAME FRIEND_FULL_NAME SELECT NAME FRIEND_FULL_NAME SAY what school did you go to | SAY MY_SCHOOL MY_SCHOOL SELECT NAME FRIEND_FULL_NAME | SAY major | SELECT NAME FRIEND_FULL_NAME SAY MY_MAJOR | SELECT NAME FRIEND_FULL_NAME	SAY sup SAY ya | SAY MY_SCHOOL you | SELECT NAME FRIEND_FULL_NAME | SAY MY_MAJOR SAY you | SELECT NAME FRIEND_FULL_NAME | PASS
START | SAY sup SAY ya | SAY MY_SCHOOL you | SELECT NAME FRIEND_FULL_NAME | SAY MY_MAJOR SAY you | SELECT NAME FRIEND_FULL_NAME	SAY any friends at MY_COMPANY or MY_COMPANY SELECT NAME FRIEND_FULL_NAME | SELECT NAME FRIEND_FULL_NAME SELECT NAME FRIEND_FULL_NAME SAY what school did you go to | SAY MY_SCHOOL MY_SCHOOL SELECT NAME FRIEND_FULL_NAME | SAY major | SELECT NAME FRIEND_FULL_NAME SAY MY_MAJOR | SELECT NAME FRIEND_FULL_NAME
START SAY all MY_COMPANY | SELECT NAME FRIEND_FULL_NAME	SAY berkley MY_MAJOR MY_COMPANY SELECT NAME FRIEND_FULL_NAME | PASS
START | SAY berkley MY_MAJOR MY_COMPANY SELECT NAME FRIEND_FULL_NAME	SAY all MY_COMPANY | SELECT NAME FRIEND_FULL_NAME
START SAY i work for MY_COMPANY and went to MY_SCHOOL | SAY do you know FRIEND_FULL_NAME or FRIEND_FULL_NAME | SAY i know FRIEND_FULL_NAME SELECT NAME FRIEND_FULL_NAME	SAY i work for MY_COMPANY and went to MY_SCHOOL | SAY no i dont SAY do you know FRIEND_FULL_NAME or FRIEND_FULL_NAME | SELECT NAME FRIEND_FULL_NAME
START | SAY i work for MY_COMPANY and went to MY_SCHOOL | SAY no i dont SAY do you know FRIEND_FULL_NAME or FRIEND_FULL_NAME | SELECT NAME FRIEND_FULL_NAME	SAY i work for MY_COMPANY and went to MY_SCHOOL | SAY do you know FRIEND_FULL_NAME or FRIEND_FULL_NAME | SAY i know FRIEND_FULL_NAME SELECT NAME FRIEND_FULL_NAME | PASS
START SAY do you have a friend studying MY_MAJOR | SAY me too i have FRIEND_FULL_NAME FRIEND_FULL_NAME and FRIEND_FULL_NAME do you know them | SAY no MY_MAJOR | SAY me too SELECT NAME FRIEND_FULL_NAME	SAY yes 3 | SAY no SAY do you know anyone studying MY_MAJOR | SAY yes FRIEND_FULL_NAME | SAY great SELECT NAME FRIEND_FULL_NAME
START | SAY yes 3 | SAY no SAY do you know anyone studying MY_MAJOR | SAY yes FRIEND_FULL_NAME | SAY great SELECT NAME FRIEND_FULL_NAME	SAY do you have a friend studying MY_MAJOR | SAY me too i have FRIEND_FULL_NAME FRIEND_FULL_NAME and FRIEND_FULL_NAME do you know them | SAY no MY_MAJOR | SAY me too SELECT NAME FRIEND_FULL_NAME | PASS
START SAY hi | SAY MY_SCHOOL MY_MAJOR MY_COMPANY | SAY do you know FRIEND_FULL_NAME SAY i dont know FRIEND_FULL_NAME | SELECT NAME FRIEND_FULL_NAME	SAY hi im u of c MY_SCHOOL MY_MAJOR MY_COMPANY | SAY do you know FRIEND_FULL_NAME | SAY yes FRIEND_FULL_NAME | SELECT NAME FRIEND_FULL_NAME
START | SAY hi im u of c MY_SCHOOL MY_MAJOR MY_COMPANY | SAY do you know FRIEND_FULL_NAME | SAY yes FRIEND_FULL_NAME | SELECT NAME FRIEND_FULL_NAME	SAY hi | SAY MY_SCHOOL MY_MAJOR MY_COMPANY | SAY do you know FRIEND_FULL_NAME SAY i dont know FRIEND_FULL_NAME | SELECT NAME FRIEND_FULL_NAME | PASS
START SAY all MY_COMPANY | SAY yes SELECT NAME FRIEND_FULL_NAME	SAY i went to MY_SCHOOL MY_MAJOR major work for MY_COMPANY SAY do you know FRIEND_FULL_NAME | SELECT NAME FRIEND_FULL_NAME
START | SAY i went to MY_SCHOOL MY_MAJOR major work for MY_COMPANY SAY do you know FRIEND_FULL_NAME | SELECT NAME FRIEND_FULL_NAME	SAY all MY_COMPANY | SAY yes SELECT NAME FRIEND_FULL_NAME | PASS
START SAY mostly MY_COMPANY 1 MY_COMPANY 1 MY_COMPANY 1 MY_COMPANY | SAY MY_COMPANY is FRIEND_FULL_NAME FRIEND_FULL_NAME is MY_COMPANY | SELECT NAME FRIEND_FULL_NAME	SAY all MY_COMPANY 1 MY_COMPANY SAY lilia mikel is MY_COMPANY | SAY yes i have FRIEND_FULL_NAME | SELECT NAME FRIEND_FULL_NAME
START | SAY all MY_COMPANY 1 MY_COMPANY SAY lilia mikel is MY_COMPANY | SAY yes i have FRIEND_FULL_NAME | SELECT NAME FRIEND_FULL_NAME	SAY mostly MY_COMPANY 1 MY_COMPANY 1 MY_COMPANY 1 MY_COMPANY | SAY MY_COMPANY is FRIEND_FULL_NAME FRIEND_FULL_NAME is MY_COMPANY | SELECT NAME FRIEND_FULL_NAME | PASS
START SAY MY_COMPANY | SAY yes | SELECT NAME FRIEND_FULL_NAME	SAY FRIEND_FULL_NAME | SELECT NAME FRIEND_FULL_NAME | PASS
START | SAY FRIEND_FULL_NAME | SELECT NAME FRIEND_FULL_NAME	SAY MY_COMPANY | SAY yes | SELECT NAME FRIEND_FULL_NAME
START SAY hello | SAY do you have lashuanda tengela FRIEND_FULL_NAME FRIEND_FULL_NAME or FRIEND_FULL_NAME | SELECT NAME FRIEND_FULL_NAME	SAY hello | SAY FRIEND_FULL_NAME SELECT NAME FRIEND_FULL_NAME | PASS
START | SAY hello | SAY FRIEND_FULL_NAME SELECT NAME FRIEND_FULL_NAME	SAY hello | SAY do you have lashuanda tengela FRIEND_FULL_NAME FRIEND_FULL_NAME or FRIEND_FULL_NAME | SELECT NAME FRIEND_FULL_NAME
START SAY hi SAY know anyone at MY_COMPANY | SAY FRIEND_FULL_NAME SELECT NAME FRIEND_FULL_NAME	SAY 1uber rest MY_COMPANY | SELECT NAME FRIEND_FULL_NAME
START | SAY 1uber rest MY_COMPANY | SELECT NAME FRIEND_FULL_NAME	SAY hi SAY know anyone at MY_COMPANY | SAY FRIEND_FULL_NAME SELECT NAME FRIEND_FULL_NAME | PASS
START SAY do you know someone who works for MY_COMPANY | SAY someone who when to u of MY_SCHOOL | SAY yes SAY someone who went to MY_SCHOOL | SAY no SAY do you know someone who went to MY_SCHOOL | SAY majored in MY_MAJOR | SAY no SAY majored in phsyics | SAY FRIEND_FULL_NAME SELECT NAME FRIEND_FULL_NAME	SAY no | SAY you have friends in MY_MAJOR | SAY no SAY FRIEND_FULL_NAME FRIEND_FULL_NAME FRIEND_FULL_NAME | SAY yes lots | SAY FRIEND_FULL_NAME | SAY FRIEND_FULL_NAME FRIEND_FULL_NAME eldonfletcherbrittney | SAY FRIEND_FULL_NAME lindhom SELECT NAME FRIEND_FULL_NAME
START | SAY no | SAY you have friends in MY_MAJOR | SAY no SAY FRIEND_FULL_NAME FRIEND_FULL_NAME FRIEND_FULL_NAME | SAY yes lots | SAY FRIEND_FULL_NAME | SAY FRIEND_FULL_NAME FRIEND_FULL_NAME eldonfletcherbrittney | SAY FRIEND_FULL_NAME lindhom SELECT NAME FRIEND_FULL_NAME	SAY do you know someone who works for MY_COMPANY | SAY someone who when to u of MY_SCHOOL | SAY yes SAY someone who went to MY_SCHOOL | SAY no SAY do you know someone who went to MY_SCHOOL | SAY majored in MY_MAJOR | SAY no SAY majored in phsyics | SAY FRIEND_FULL_NAME SELECT NAME FRIEND_FULL_NAME | PASS
START SAY i went to upenn MY_MAJOR major work for MY_COMPANY | SAY do you know FRIEND_FULL_NAME | SAY yes FRIEND_FULL_NAME SELECT NAME FRIEND_FULL_NAME	SAY hi went to MY_SCHOOL majored in MY_MAJOR and work for MY_COMPANY | SAY FRIEND_FULL_NAME | SELECT NAME FRIEND_FULL_NAME
START | SAY hi went to MY_SCHOOL majored in MY_MAJOR and work for MY_COMPANY | SAY FRIEND_FULL_NAME | SELECT NAME FRIEND_FULL_NAME	SAY i went to upenn MY_MAJOR major work for MY_COMPANY | SAY do you know FRIEND_FULL_NAME | SAY yes FRIEND_FULL_NAME SELECT NAME FRIEND_FULL_NAME | PASS
START SAY hi | SAY MY_SCHOOL MY_MAJOR MY_COMPANY SAY what about you | SELECT NAME FRIEND_FULL_NAME	SAY hi | SELECT NAME FRIEND_FULL_NAME | PASS
START | SAY hi | SELECT NAME FRIEND_FULL_NAME	SAY hi | SAY MY_SCHOOL MY_MAJOR MY_COMPANY SAY what about you | SELECT NAME FRIEND_FULL_NAME
START SAY any friends at MY_COMPANY | SELECT NAME FRIEND_FULL_NAME SAY i went to MY_SCHOOL | SELECT NAME FRIEND_FULL_NAME | SAY the rest of mine are MY_COMPANY | SELECT NAME FRIEND_FULL_NAME	SAY u of MY_SCHOOL SAY yes a lot | SAY i dontb know a quin | SAY no loraine | SAY FRIEND_FULL_NAME | SELECT NAME FRIEND_FULL_NAME
START | SAY u of MY_SCHOOL SAY yes a lot | SAY i dontb know a quin | SAY no loraine | SAY FRIEND_FULL_NAME | SELECT NAME FRIEND_FULL_NAME	SAY any friends at MY_COMPANY | SELECT NAME FRIEND_FULL_NAME SAY i went to MY_SCHOOL | SELECT NAME FRIEND_FULL_NAME | SAY the rest of mine are MY_COMPANY | SELECT NAME FRIEND_FULL_NAME | PASS
START SAY hello | SAY hi i am patricia gearhart SAY from uc MY_SCHOOL | SAY i know FRIEND_FULL_NAME as well | SELECT NAME FRIEND_FULL_NAME	SAY hi im FRIEND_FULL_NAME from standford SAY do you know anyone from MY_SCHOOL | SAY i know FRIEND_FULL_NAME sarman FRIEND_FULL_NAME and FRIEND_FULL_NAME from there 3 SAY what is your major company | SAY mines MY_MAJOR MY_COMPANY SELECT NAME FRIEND_FULL_NAME | PASS
START | SAY hi im FRIEND_FULL_NAME from standford SAY do you know anyone from MY_SCHOOL | SAY i know FRIEND_FULL_NAME sarman FRIEND_FULL_NAME and FRIEND_FULL_NAME from there 3 SAY what is your major company | SAY mines MY_MAJOR MY_COMPANY SELECT NAME FRIEND_FULL_NAME	SAY hello | SAY hi i am patricia gearhart SAY from uc MY_SCHOOL | SAY i know FRIEND_FULL_NAME as well | SELECT NAME FRIEND_FULL_NAME
START SAY 2 MY_COMPANY rest appple SAY MY_COMPANY | SAY no | SELECT NAME FRIEND_FULL_NAME	SAY know a FRIEND_FULL_NAME FRIEND_FULL_NAME albertom FRIEND_FULL_NAME FRIEND_FULL_NAME FRIEND_FULL_NAME | SAY FRIEND_FULL_NAME FRIEND_FULL_NAME FRIEND_FULL_NAME FRIEND_FULL_NAME | SELECT NAME FRIEND_FULL_NAME
START | SAY know a FRIEND_FULL_NAME FRIEND_FULL_NAME albertom FRIEND_FULL_NAME FRIEND_FULL_NAME FRIEND_FULL_NAME | SAY FRIEND_FULL_NAME FRIEND_FULL_NAME FRIEND_FULL_NAME FRIEND_FULL_NAME | SELECT NAME FRIEND_FULL_NAME	SAY 2 MY_COMPANY rest appple SAY MY_COMPANY | SAY no | SELECT NAME FRIEND_FULL_NAME | PASS
START SAY went to MY_SCHOOL for linguisitics and i work at MY_COMPANY SAY you SAY i went to MY_SCHOOL for MY_MAJOR and i work at MY_COMPANY | SELECT NAME FRIEND_FULL_NAME	SELECT NAME FRIEND_FULL_NAME | PASS
START | SELECT NAME FRIEND_FULL_NAME	SAY went to MY_SCHOOL for linguisitics and i work at MY_COMPANY SAY you SAY i went to MY_SCHOOL for MY_MAJOR and i work at MY_COMPANY | SELECT NAME FRIEND_FULL_NAME
START SAY all MY_COMPANY 1 MY_COMPANY | SELECT NAME FRIEND_FULL_NAME	SAY FRIEND_FULL_NAME SELECT NAME FRIEND_FULL_NAME | PASS
START | SAY FRIEND_FULL_NAME SELECT NAME FRIEND_FULL_NAME	SAY all MY_COMPANY 1 MY_COMPANY | SELECT NAME FRIEND_FULL_NAME
START SAY FRIEND_FULL_NAME | SAY FRIEND_FULL_NAME SAY FRIEND_FULL_NAME SAY FRIEND_FULL_NAME | SELECT NAME FRIEND_FULL_NAME	SAY MY_SCHOOL | SELECT NAME FRIEND_FULL_NAME | PASS
START | SAY MY_SCHOOL | SELECT NAME FRIEND_FULL_NAME	SAY FRIEND_FULL_NAME | SAY FRIEND_FULL_NAME SAY FRIEND_FULL_NAME SAY FRIEND_FULL_NAME | SELECT NAME FRIEND_FULL_NAME
START SAY britt joet kendr dlebe lucien FRIEND_FULL_NAME jose FRIEND_FULL_NAME albert FRIEND_FULL_NAME | SELECT NAME FRIEND_FULL_NAME	SAY FRIEND_FULL_NAME SELECT NAME FRIEND_FULL_NAME | PASS
START | SAY FRIEND_FULL_NAME SELECT NAME FRIEND_FULL_NAME	SAY britt joet kendr dlebe lucien FRIEND_FULL_NAME jose FRIEND_FULL_NAME albert FRIEND_FULL_NAME | SELECT NAME FRIEND_FULL_NAME
START SAY i went to standford SAY and i work at MY_COMPANY | SAY yes SELECT NAME FRIEND_FULL_NAME	SAY do you know FRIEND_FULL_NAME | SELECT NAME FRIEND_FULL_NAME
START | SAY do you know FRIEND_FULL_NAME | SELECT NAME FRIEND_FULL_NAME	SAY i went to standford SAY and i work at MY_COMPANY | SAY yes SELECT NAME FRIEND_FULL_NAME | PASS
START SAY hi do you know FRIEND_FULL_NAME SAY MY_SCHOOL SAY major in MY_MAJOR SAY MY_COMPANY | SAY FRIEND_FULL_NAME | SAY FRIEND_FULL_NAME SAY FRIEND_FULL_NAME | SAY FRIEND_FULL_NAME | SAY FRIEND_FULL_NAME | SAY FRIEND_FULL_NAME | SELECT NAME FRIEND_FULL_NAME	SAY no SAY know anyone from MY_COMPANY | SAY nope SAY anyone else from MY_SCHOOL | SAY nope | SAY nope | SAY nope | SAY yes SELECT NAME FRIEND_FULL_NAME | PASS
START | SAY no SAY know anyone from MY_COMPANY | SAY nope SAY anyone else from MY_SCHOOL | SAY nope | SAY nope | SAY nope | SAY yes SELECT NAME FRIEND_FULL_NAME	SAY hi do you know FRIEND_FULL_NAME SAY MY_SCHOOL SAY major in MY_MAJOR SAY MY_COMPANY | SAY FRIEND_FULL_NAME | SAY FRIEND_FULL_NAME SAY FRIEND_FULL_NAME | SAY FRIEND_FULL_NAME | SAY FRIEND_FULL_NAME | SAY FRIEND_FULL_NAME | SELECT NAME FRIEND_FULL_NAME
START SAY all MY_COMPANY 1 MY_COMPANY 1 MY_COMPANY | SELECT NAME FRIEND_FULL_NAME	SAY do you know people at MY_SCHOOL of MY_SCHOOL | SAY or MY_SCHOOL or MY_SCHOOL or uc berkley SAY aha i have her too SELECT NAME FRIEND_FULL_NAME
START | SAY do you know people at MY_SCHOOL of MY_SCHOOL | SAY or MY_SCHOOL or MY_SCHOOL or uc berkley SAY aha i have her too SELECT NAME FRIEND_FULL_NAME	SAY all MY_COMPANY 1 MY_COMPANY 1 MY_COMPANY | SELECT NAME FRIEND_FULL_NAME | PASS
START SAY any friends at MY_COMPANY SELECT NAME FRIEND_FULL_NAME | SELECT NAME FRIEND_FULL_NAME | SAY the rest of mine are MY_COMPANY any at MY_COMPANY SELECT NAME FRIEND_FULL_NAME | SAY yes FRIEND_FULL_NAME SAY i have it set but not registering SELECT NAME FRIEND_FULL_NAME | SELECT NAME FRIEND_FULL_NAME	SAY yep a few | SELECT NAME FRIEND_FULL_NAME SAY mostly MY_MAJOR | SAY oh SELECT NAME FRIEND_FULL_NAME SAY thats mine at MY_COMPANY | SAY huh well thats my only MY_COMPANY person so we should have won then | PASS
START | SAY yep a few | SELECT NAME FRIEND_FULL_NAME SAY mostly MY_MAJOR | SAY oh SELECT NAME FRIEND_FULL_NAME SAY thats mine at MY_COMPANY | SAY huh well thats my only MY_COMPANY person so we should have won then	SAY any friends at MY_COMPANY SELECT NAME FRIEND_FULL_NAME | SELECT NAME FRIEND_FULL_NAME | SAY the rest of mine are MY_COMPANY any at MY_COMPANY SELECT NAME FRIEND_FULL_NAME | SAY yes FRIEND_FULL_NAME SAY i have it set but not registering SELECT NAME FRIEND_FULL_NAME | SELECT NAME FRIEND_FULL_NAME
START SAY hello | SAY i went to the MY_SCHOOL my major was MY_MAJOR and i work at MY_COMPANY SAY what about you | SAY FRIEND_FULL_NAME | SELECT NAME FRIEND_FULL_NAME	SAY hi | SAY i went to MY_SCHOOL MY_MAJOR | SAY i have FRIEND_FULL_NAME | SAY and FRIEND_FULL_NAME SELECT NAME FRIEND_FULL_NAME
START | SAY hi | SAY i went to MY_SCHOOL MY_MAJOR | SAY i have FRIEND_FULL_NAME | SAY and FRIEND_FULL_NAME SELECT NAME FRIEND_FULL_NAME	SAY hello | SAY i went to the MY_SCHOOL my major was MY_MAJOR and i work at MY_COMPANY SAY what about you | SAY FRIEND_FULL_NAME | SELECT NAME FRIEND_FULL_NAME | PASS
START SAY hi SAY hi SAY i went to MY_SCHOOL of MY_SCHOOL majored in MY_MAJOR and work at MY_COMPANY | SAY what about you | SAY i dont know that person | SAY yes i know her SELECT NAME FRIEND_FULL_NAME	SAY whats your alma mater | SELECT NAME FRIEND_FULL_NAME | SELECT NAME FRIEND_FULL_NAME | PASS
START | SAY whats your alma mater | SELECT NAME FRIEND_FULL_NAME | SELECT NAME FRIEND_FULL_NAME	SAY hi SAY hi SAY i went to MY_SCHOOL of MY_SCHOOL majored in MY_MAJOR and work at MY_COMPANY | SAY what about you | SAY i dont know that person | SAY yes i know her SELECT NAME FRIEND_FULL_NAME
START SAY i went to MY_SCHOOL and work for MY_COMPANY | SAY no | SAY yes | SELECT NAME FRIEND_FULL_NAME	SAY anyone from MY_COMPANY | SAY FRIEND_FULL_NAME from fb | SELECT NAME FRIEND_FULL_NAME | PASS
START | SAY anyone from MY_COMPANY | SAY FRIEND_FULL_NAME from fb | SELECT NAME FRIEND_FULL_NAME	SAY i went to MY_SCHOOL and work for MY_COMPANY | SAY no | SAY yes | SELECT NAME FRIEND_FULL_NAME
START SAY i work for MY_COMPANY SAY and went to upenn | SELECT NAME FRIEND_FULL_NAME | SAY oh	SAY how about FRIEND_FULL_NAME FRIEND_FULL_NAME FRIEND_FULL_NAME lorraiamnm FRIEND_FULL_NAME FRIEND_FULL_NAME | SAY emmanu FRIEND_FULL_NAME FRIEND_FULL_NAME FRIEND_FULL_NAME SAY no coffman | SELECT NAME FRIEND_FULL_NAME
START | SAY how about FRIEND_FULL_NAME FRIEND_FULL_NAME FRIEND_FULL_NAME lorraiamnm FRIEND_FULL_NAME FRIEND_FULL_NAME | SAY emmanu FRIEND_FULL_NAME FRIEND_FULL_NAME FRIEND_FULL_NAME SAY no coffman | SELECT NAME FRIEND_FULL_NAME	SAY i work for MY_COMPANY SAY and went to upenn | SELECT NAME FRIEND_FULL_NAME | SAY oh | PASS
START SAY FRIEND_FULL_NAME | SAY FRIEND_FULL_NAME SAY FRIEND_FULL_NAME SAY FRIEND_FULL_NAME SAY FRIEND_FULL_NAME | SAY FRIEND_FULL_NAME SAY FRIEND_FULL_NAME SAY FRIEND_FULL_NAME | SAY FRIEND_FULL_NAME | SELECT NAME FRIEND_FULL_NAME	SAY MY_SCHOOL MY_MAJOR MY_COMPANY | SAY its either to give school major company SAY than list each | SAY FRIEND_FULL_NAME | SELECT NAME FRIEND_FULL_NAME | PASS
START | SAY MY_SCHOOL MY_MAJOR MY_COMPANY | SAY its either to give school major company SAY than list each | SAY FRIEND_FULL_NAME | SELECT NAME FRIEND_FULL_NAME	SAY FRIEND_FULL_NAME | SAY FRIEND_FULL_NAME SAY FRIEND_FULL_NAME SAY FRIEND_FULL_NAME SAY FRIEND_FULL_NAME | SAY FRIEND_FULL_NAME SAY FRIEND_FULL_NAME SAY FRIEND_FULL_NAME | SAY FRIEND_FULL_NAME | SELECT NAME FRIEND_FULL_NAME
START SAY MY_COMPANY | SAY MY_COMPANY | SAY none | SAY lots | SELECT NAME FRIEND_FULL_NAME	SAY none | SAY MY_COMPANY | SAY or MY_COMPANY | SAY FRIEND_FULL_NAME SAY or FRIEND_FULL_NAME | SELECT NAME FRIEND_FULL_NAME
START | SAY none | SAY MY_COMPANY | SAY or MY_COMPANY | SAY FRIEND_FULL_NAME SAY or FRIEND_FULL_NAME | SELECT NAME FRIEND_FULL_NAME	SAY MY_COMPANY | SAY MY_COMPANY | SAY none | SAY lots | SELECT NAME FRIEND_FULL_NAME | PASS
START SAY hi there SAY FRIEND_FULL_NAME FRIEND_FULL_NAME nathan ayesh kend keesh john FRIEND_FULL_NAME llila albert got any of those folks SAY god awful names SAY hello | SELECT NAME FRIEND_FULL_NAME	SAY i have FRIEND_FULL_NAME | SELECT NAME FRIEND_FULL_NAME
START | SAY i have FRIEND_FULL_NAME | SELECT NAME FRIEND_FULL_NAME	SAY hi there SAY FRIEND_FULL_NAME FRIEND_FULL_NAME nathan ayesh kend keesh john FRIEND_FULL_NAME llila albert got any of those folks SAY god awful names SAY hello | SELECT NAME FRIEND_FULL_NAME | PASS
START SAY columbiamathgoogle SAY u | SAY 2 in MY_COMPANY | SAY FRIEND_FULL_NAME and quin | SELECT NAME FRIEND_FULL_NAME	SAY you have a friend working in MY_COMPANY or MY_COMPANY | SAY names | SAY FRIEND_FULL_NAME SELECT NAME FRIEND_FULL_NAME | PASS
START | SAY you have a friend working in MY_COMPANY or MY_COMPANY | SAY names | SAY FRIEND_FULL_NAME SELECT NAME FRIEND_FULL_NAME	SAY columbiamathgoogle SAY u | SAY 2 in MY_COMPANY | SAY FRIEND_FULL_NAME and quin | SELECT NAME FRIEND_FULL_NAME
START SAY i went to MY_SCHOOL MY_MAJOR major work for MY_COMPANY | SAY do you know FRIEND_FULL_NAME SAY or FRIEND_FULL_NAME | SELECT NAME FRIEND_FULL_NAME	SAY u of MY_SCHOOL comuter MY_MAJOR work for MY_COMPANY | SAY no kathleen bo SAY yes ken friday SELECT NAME FRIEND_FULL_NAME | PASS
START | SAY u of MY_SCHOOL comuter MY_MAJOR work for MY_COMPANY | SAY no kathleen bo SAY yes ken friday SELECT NAME FRIEND_FULL_NAME	SAY i went to MY_SCHOOL MY_MAJOR major work for MY_COMPANY | SAY do you know FRIEND_FULL_NAME SAY or FRIEND_FULL_NAME | SELECT NAME FRIEND_FULL_NAME
START SAY hi SAY friends FRIEND_FULL_NAME FRIEND_FULL_NAME FRIEND_FULL_NAME FRIEND_FULL_NAME FRIEND_FULL_NAME | SAY FRIEND_FULL_NAME SELECT NAME FRIEND_FULL_NAME	SAY FRIEND_FULL_NAME FRIEND_FULL_NAME FRIEND_FULL_NAME FRIEND_FULL_NAME FRIEND_FULL_NAME | SELECT NAME FRIEND_FULL_NAME
START | SAY FRIEND_FULL_NAME FRIEND_FULL_NAME FRIEND_FULL_NAME FRIEND_FULL_NAME FRIEND_FULL_NAME | SELECT NAME FRIEND_FULL_NAME	SAY hi SAY friends FRIEND_FULL_NAME FRIEND_FULL_NAME FRIEND_FULL_NAME FRIEND_FULL_NAME FRIEND_FULL_NAME | SAY FRIEND_FULL_NAME SELECT NAME FRIEND_FULL_NAME | PASS
START SAY all MY_COMPANY 1 MY_COMPANY | SELECT NAME FRIEND_FULL_NAME	SAY i went to MY_SCHOOL berkbeley major in MY_MAJOR work at MY_COMPANY SAY all friends work at MY_COMPANY with one at MY_COMPANY named FRIEND_FULL_NAME SAY you know FRIEND_FULL_NAME | SELECT NAME FRIEND_FULL_NAME
START | SAY i went to MY_SCHOOL berkbeley major in MY_MAJOR work at MY_COMPANY SAY all friends work at MY_COMPANY with one at MY_COMPANY named FRIEND_FULL_NAME SAY you know FRIEND_FULL_NAME | SELECT NAME FRIEND_FULL_NAME	SAY all MY_COMPANY 1 MY_COMPANY | SELECT NAME FRIEND_FULL_NAME | PASS
START SAY FRIEND_FULL_NAME than FRIEND_FULL_NAME geenie olive SAY FRIEND_FULL_NAME FRIEND_FULL_NAME krist FRIEND_FULL_NAME bernit | SELECT NAME FRIEND_FULL_NAME	SAY none SAY none SAY FRIEND_FULL_NAME | SELECT NAME FRIEND_FULL_NAME
START | SAY none SAY none SAY FRIEND_FULL_NAME | SELECT NAME FRIEND_FULL_NAME	SAY FRIEND_FULL_NAME than FRIEND_FULL_NAME geenie olive SAY FRIEND_FULL_NAME FRIEND_FULL_NAME krist FRIEND_FULL_NAME bernit | SELECT NAME FRIEND_FULL_NAME | PASS
START SAY i went to MY_SCHOOL and work for MY_COMPANY | SELECT NAME FRIEND_FULL_NAME	SAY here is mine pick one in common SAY piggott SAY mccolley SAY FRIEND_FULL_NAME SAY prouty SAY cesla SAY FRIEND_FULL_NAME SAY kenley SAY brough SAY towery SAY scheu SAY FRIEND_FULL_NAME SAY whichone is also on your list that is the answer SELECT NAME FRIEND_FULL_NAME SELECT NAME FRIEND_FULL_NAME | PASS
START | SAY here is mine pick one in common SAY piggott SAY mccolley SAY FRIEND_FULL_NAME SAY prouty SAY cesla SAY FRIEND_FULL_NAME SAY kenley SAY brough SAY towery SAY scheu SAY FRIEND_FULL_NAME SAY whichone is also on your list that is the answer SELECT NAME FRIEND_FULL_NAME SELECT NAME FRIEND_FULL_NAME	SAY i went to MY_SCHOOL and work for MY_COMPANY | SELECT NAME FRIEND_FULL_NAME
START SAY went to MY_SCHOOL major in MY_MAJOR work at MY_COMPANY | SAY do you know FRIEND_FULL_NAME | SAY yes i know FRIEND_FULL_NAME | SELECT NAME FRIEND_FULL_NAME	SAY im MY_SCHOOL MY_MAJOR MY_COMPANY | SAY do you know FRIEND_FULL_NAME FRIEND_FULL_NAME or FRIEND_FULL_NAME SAY no FRIEND_FULL_NAME | SELECT NAME FRIEND_FULL_NAME | PASS
START | SAY im MY_SCHOOL MY_MAJOR MY_COMPANY | SAY do you know FRIEND_FULL_NAME FRIEND_FULL_NAME or FRIEND_FULL_NAME SAY no FRIEND_FULL_NAME | SELECT NAME FRIEND_FULL_NAME	SAY went to MY_SCHOOL major in MY_MAJOR work at MY_COMPANY | SAY do you know FRIEND_FULL_NAME | SAY yes i know FRIEND_FULL_NAME | SELECT NAME FRIEND_FULL_NAME
START SAY does your friend attend the university of pennsylvanis SAY what is your friends major SAY what company does your friend work for SAY hello are you there | SELECT NAME FRIEND_FULL_NAME	SAY MY_COMPANY | SAY MY_SCHOOL SAY yes SAY FRIEND_FULL_NAME SELECT NAME FRIEND_FULL_NAME
START | SAY MY_COMPANY | SAY MY_SCHOOL SAY yes SAY FRIEND_FULL_NAME SELECT NAME FRIEND_FULL_NAME	SAY does your friend attend the university of pennsylvanis SAY what is your friends major SAY what company does your friend work for SAY hello are you there | SELECT NAME FRIEND_FULL_NAME | PASS
START SAY hello | SAY i went to MY_SCHOOL majored in MY_MAJOR and i work at MY_COMPANY SAY no sorry | SELECT NAME FRIEND_FULL_NAME	SAY any of your friends FRIEND_FULL_NAME FRIEND_FULL_NAME | SAY FRIEND_FULL_NAME raymon FRIEND_FULL_NAME FRIEND_FULL_NAME | SAY zachary FRIEND_FULL_NAME FRIEND_FULL_NAME SELECT NAME FRIEND_FULL_NAME
START | SAY any of your friends FRIEND_FULL_NAME FRIEND_FULL_NAME | SAY FRIEND_FULL_NAME raymon FRIEND_FULL_NAME FRIEND_FULL_NAME | SAY zachary FRIEND_FULL_NAME FRIEND_FULL_NAME SELECT NAME FRIEND_FULL_NAME	SAY hello | SAY i went to MY_SCHOOL majored in MY_MAJOR and i work at MY_COMPANY SAY no sorry | SELECT NAME FRIEND_FULL_NAME | PASS
START SAY brkley MY_MAJOR MY_COMPANY | SAY do you know lorrian hrulbert | SAY or FRIEND_FULL_NAME SELECT NAME FRIEND_FULL_NAME	SAY hi i work at MY_COMPANY went to MY_SCHOOL majored in MY_MAJOR | SAY FRIEND_FULL_NAME | SELECT NAME FRIEND_FULL_NAME
START | SAY hi i work at MY_COMPANY went to MY_SCHOOL majored in MY_MAJOR | SAY FRIEND_FULL_NAME | SELECT NAME FRIEND_FULL_NAME	SAY brkley MY_MAJOR MY_COMPANY | SAY do you know lorrian hrulbert | SAY or FRIEND_FULL_NAME SELECT NAME FRIEND_FULL_NAME | PASS
START SAY hey | SAY i go to MY_SCHOOL major in MY_MAJOR and work for MY_COMPANY | SAY no | SAY yeah | SELECT NAME FRIEND_FULL_NAME	SAY hello | SAY do you know FRIEND_FULL_NAME | SAY FRIEND_FULL_NAME | SELECT NAME FRIEND_FULL_NAME | PASS
START | SAY hello | SAY do you know FRIEND_FULL_NAME | SAY FRIEND_FULL_NAME | SELECT NAME FRIEND_FULL_NAME	SAY hey | SAY i go to MY_SCHOOL major in MY_MAJOR and work for MY_COMPANY | SAY no | SAY yeah | SELECT NAME FRIEND_FULL_NAME
START SAY i went to MY_SCHOOL and majored in MY_MAJOR SAY how about you | SAY FRIEND_FULL_NAME | SAY nope SAY company MY_COMPANY | SAY MY_COMPANY SAY FRIEND_FULL_NAME | SELECT NAME FRIEND_FULL_NAME	SAY MY_SCHOOL MY_MAJOR | SAY FRIEND_FULL_NAME | SAY MY_COMPANY you | SAY yes sorry | SELECT NAME FRIEND_FULL_NAME
START | SAY MY_SCHOOL MY_MAJOR | SAY FRIEND_FULL_NAME | SAY MY_COMPANY you | SAY yes sorry | SELECT NAME FRIEND_FULL_NAME	SAY i went to MY_SCHOOL and majored in MY_MAJOR SAY how about you | SAY FRIEND_FULL_NAME | SAY nope SAY company MY_COMPANY | SAY MY_COMPANY SAY FRIEND_FULL_NAME | SELECT NAME FRIEND_FULL_NAME | PASS
START SAY any friends at MY_COMPANY | SELECT NAME FRIEND_FULL_NAME	SAY ucberkeley MY_MAJOR work at MY_COMPANY | SELECT NAME FRIEND_FULL_NAME
START | SAY ucberkeley MY_MAJOR work at MY_COMPANY | SELECT NAME FRIEND_FULL_NAME	SAY any friends at MY_COMPANY | SELECT NAME FRIEND_FULL_NAME | PASS
START SAY i went to MY_SCHOOL for MY_MAJOR and work at MY_COMPANY | SELECT NAME FRIEND_FULL_NAME	SAY just match names SAY FRIEND_FULL_NAME SAY FRIEND_FULL_NAME SAY FRIEND_FULL_NAME SAY FRIEND_FULL_NAME SAY FRIEND_FULL_NAME | SELECT NAME FRIEND_FULL_NAME
START | SAY just match names SAY FRIEND_FULL_NAME SAY FRIEND_FULL_NAME SAY FRIEND_FULL_NAME SAY FRIEND_FULL_NAME SAY FRIEND_FULL_NAME | SELECT NAME FRIEND_FULL_NAME	SAY i went to MY_SCHOOL for MY_MAJOR and work at MY_COMPANY | SELECT NAME FRIEND_FULL_NAME | PASS
START SAY do you know FRIEND_FULL_NAME FRIEND_FULL_NAME FRIEND_FULL_NAME FRIEND_FULL_NAME or FRIEND_FULL_NAME | SAY or FRIEND_FULL_NAME FRIEND_FULL_NAME FRIEND_FULL_NAME FRIEND_FULL_NAME or FRIEND_FULL_NAME | SAY MY_SCHOOL MY_MAJOR MY_COMPANY SELECT NAME FRIEND_FULL_NAME	SAY no | SELECT NAME FRIEND_FULL_NAME | PASS
START | SAY no | SELECT NAME FRIEND_FULL_NAME	SAY do you know FRIEND_FULL_NAME FRIEND_FULL_NAME FRIEND_FULL_NAME FRIEND_FULL_NAME or FRIEND_FULL_NAME | SAY or FRIEND_FULL_NAME FRIEND_FULL_NAME FRIEND_FULL_NAME FRIEND_FULL_NAME or FRIEND_FULL_NAME | SAY MY_SCHOOL MY_MAJOR MY_COMPANY SELECT NAME FRIEND_FULL_NAME
START SAY all MY_COMPANY | SELECT NAME FRIEND_FULL_NAME	SAY 1 MY_COMPANY SAY FRIEND_FULL_NAME | SELECT NAME FRIEND_FULL_NAME
START | SAY 1 MY_COMPANY SAY FRIEND_FULL_NAME | SELECT NAME FRIEND_FULL_NAME	SAY all MY_COMPANY | SELECT NAME FRIEND_FULL_NAME | PASS
START SAY hi there | SAY FRIEND_FULL_NAME SAY FRIEND_FULL_NAME | SAY stuipid names | SELECT NAME FRIEND_FULL_NAME	SAY hi berkley MY_MAJOR MY_COMPANY | SAY no | SAY FRIEND_FULL_NAME yes SELECT NAME FRIEND_FULL_NAME | PASS
START | SAY hi berkley MY_MAJOR MY_COMPANY | SAY no | SAY FRIEND_FULL_NAME yes SELECT NAME FRIEND_FULL_NAME	SAY hi there | SAY FRIEND_FULL_NAME SAY FRIEND_FULL_NAME | SAY stuipid names | SELECT NAME FRIEND_FULL_NAME
START SAY FRIEND_FULL_NAME | SAY FRIEND_FULL_NAME | SAY FRIEND_FULL_NAME | SELECT NAME FRIEND_FULL_NAME	SAY 1 MY_COMPANY 1 MY_COMPANY rest MY_COMPANY SAY no | SAY no SAY FRIEND_FULL_NAME FRIEND_FULL_NAME FRIEND_FULL_NAME FRIEND_FULL_NAME | SELECT NAME FRIEND_FULL_NAME | PASS
START | SAY 1 MY_COMPANY 1 MY_COMPANY rest MY_COMPANY SAY no | SAY no SAY FRIEND_FULL_NAME FRIEND_FULL_NAME FRIEND_FULL_NAME FRIEND_FULL_NAME | SELECT NAME FRIEND_FULL_NAME	SAY FRIEND_FULL_NAME | SAY FRIEND_FULL_NAME | SAY FRIEND_FULL_NAME | SELECT NAME FRIEND_FULL_NAME
START SAY all friends at MY_COMPANY except one at MY_COMPANY a FRIEND_FULL_NAME | SAY all friends went to MY_SCHOOL except two at MY_SCHOOL and one at MY_SCHOOL SELECT NAME FRIEND_FULL_NAME	SELECT NAME FRIEND_FULL_NAME | PASS
START | SELECT NAME FRIEND_FULL_NAME	SAY all friends at MY_COMPANY except one at MY_COMPANY a FRIEND_FULL_NAME | SAY all friends went to MY_SCHOOL except two at MY_SCHOOL and one at MY_SCHOOL SELECT NAME FRIEND_FULL_NAME
START SAY hi know anybody from MY_SCHOOL who works at MY_COMPANY | SAY no | SAY FRIEND_FULL_NAME SAY FRIEND_FULL_NAME | SELECT NAME FRIEND_FULL_NAME	SELECT NAME FRIEND_FULL_NAME | SAY sorry SAY nah i dont SAY i know one that went to MY_SCHOOL tho | SAY yea FRIEND_FULL_NAME | SELECT NAME FRIEND_FULL_NAME
START | SELECT NAME FRIEND_FULL_NAME | SAY sorry SAY nah i dont SAY i know one that went to MY_SCHOOL tho | SAY yea FRIEND_FULL_NAME | SELECT NAME FRIEND_FULL_NAME	SAY hi know anybody from MY_SCHOOL who works at MY_COMPANY | SAY no | SAY FRIEND_FULL_NAME SAY FRIEND_FULL_NAME | SELECT NAME FRIEND_FULL_NAME | PASS
START SAY yoyo | SAY sharman SAY yes | SELECT NAME FRIEND_FULL_NAME	SAY anyone from MY_COMPANY SAY FRIEND_FULL_NAME | SELECT NAME FRIEND_FULL_NAME | PASS
START | SAY anyone from MY_COMPANY SAY FRIEND_FULL_NAME | SELECT NAME FRIEND_FULL_NAME	SAY yoyo | SAY sharman SAY yes | SELECT NAME FRIEND_FULL_NAME
START SAY hi | SAY FRIEND_FULL_NAME here u o MY_SCHOOL MY_MAJOR MY_COMPANY | SAY i know FRIEND_FULL_NAME FRIEND_FULL_NAME FRIEND_FULL_NAME FRIEND_FULL_NAME SAY no FRIEND_FULL_NAME | SAY yes | SELECT NAME FRIEND_FULL_NAME	SAY hi anyone there SAY hi SAY i went to MY_SCHOOL majored in MY_MAJOR MY_MAJOR and work for MY_COMPANY SAY how about u | SAY do you know FRIEND_FULL_NAME | SAY FRIEND_FULL_NAME | SAY ok SELECT NAME FRIEND_FULL_NAME | PASS
START | SAY hi anyone there SAY hi SAY i went to MY_SCHOOL majored in MY_MAJOR MY_MAJOR and work for MY_COMPANY SAY how about u | SAY do you know FRIEND_FULL_NAME | SAY FRIEND_FULL_NAME | SAY ok SELECT NAME FRIEND_FULL_NAME	SAY hi | SAY FRIEND_FULL_NAME here u o MY_SCHOOL MY_MAJOR MY_COMPANY | SAY i know FRIEND_FULL_NAME FRIEND_FULL_NAME FRIEND_FULL_NAME FRIEND_FULL_NAME SAY no FRIEND_FULL_NAME | SAY yes | SELECT NAME FRIEND_FULL_NAME
START SAY any of your people FRIEND_FULL_NAME FRIEND_FULL_NAME FRIEND_FULL_NAME SAY neau FRIEND_FULL_NAME FRIEND_FULL_NAME | SAY FRIEND_FULL_NAME FRIEND_FULL_NAME FRIEND_FULL_NAME FRIEND_FULL_NAME SELECT NAME FRIEND_FULL_NAME	SAY FRIEND_FULL_NAME | SELECT NAME FRIEND_FULL_NAME
START | SAY FRIEND_FULL_NAME | SELECT NAME FRIEND_FULL_NAME	SAY any of your people FRIEND_FULL_NAME FRIEND_FULL_NAME FRIEND_FULL_NAME SAY neau FRIEND_FULL_NAME FRIEND_FULL_NAME | SAY FRIEND_FULL_NAME FRIEND_FULL_NAME FRIEND_FULL_NAME FRIEND_FULL_NAME SELECT NAME FRIEND_FULL_NAME | PASS
START SAY berkelylinguisticsgoogle SAY u | SAY FRIEND_FULL_NAME | SELECT NAME FRIEND_FULL_NAME	SAY columbiamathfb | SAY yup | SELECT NAME FRIEND_FULL_NAME
START | SAY columbiamathfb | SAY yup | SELECT NAME FRIEND_FULL_NAME	SAY berkelylinguisticsgoogle SAY u | SAY FRIEND_FULL_NAME | SELECT NAME FRIEND_FULL_NAME | PASS
START SAY upenn MY_MAJOR MY_COMPANY | SELECT NAME FRIEND_FULL_NAME | SAY you SAY school major company | SAY then shes the one in common	SAY nope | SAY nope | SAY ive got her but she works for MY_COMPANY | SELECT NAME FRIEND_FULL_NAME
START | SAY nope | SAY nope | SAY ive got her but she works for MY_COMPANY | SELECT NAME FRIEND_FULL_NAME	SAY upenn MY_MAJOR MY_COMPANY | SELECT NAME FRIEND_FULL_NAME | SAY you SAY school major company | SAY then shes the one in common | PASS
START SAY hello SAY do you know FRIEND_FULL_NAME SAY brabar SAY hello | SAY FRIEND_FULL_NAME | SAY 9 from MY_COMPANY 1 from MY_COMPANY SAY FRIEND_FULL_NAME | SELECT NAME FRIEND_FULL_NAME	SAY hi i kust know a guy from MY_COMPANY 2 MY_COMPANY 1 MY_COMPANY and orthers are all from MY_COMPANY | SAY no know many people know from the companies | SAY do you know a FRIEND_FULL_NAME ou FRIEND_FULL_NAME | SELECT NAME FRIEND_FULL_NAME
START | SAY hi i kust know a guy from MY_COMPANY 2 MY_COMPANY 1 MY_COMPANY and orthers are all from MY_COMPANY | SAY no know many people know from the companies | SAY do you know a FRIEND_FULL_NAME ou FRIEND_FULL_NAME | SELECT NAME FRIEND_FULL_NAME	SAY hello SAY do you know FRIEND_FULL_NAME SAY brabar SAY hello | SAY FRIEND_FULL_NAME | SAY 9 from MY_COMPANY 1 from MY_COMPANY SAY FRIEND_FULL_NAME | SELECT NAME FRIEND_FULL_NAME | PASS
START SAY all MY_COMPANY | SELECT NAME FRIEND_FULL_NAME	SELECT NAME FRIEND_FULL_NAME | PASS
START | SELECT NAME FRIEND_FULL_NAME	SAY all MY_COMPANY | SELECT NAME FRIEND_FULL_NAME
START SAY hey | SAY yeah SELECT NAME FRIEND_FULL_NAME	SAY 1 fb the rest MY_COMPANY SAY FRIEND_FULL_NAME | SELECT NAME FRIEND_FULL_NAME
START | SAY 1 fb the rest MY_COMPANY SAY FRIEND_FULL_NAME | SELECT NAME FRIEND_FULL_NAME	SAY hey | SAY yeah SELECT NAME FRIEND_FULL_NAME | PASS
START SAY FRIEND_FULL_NAME SAY FRIEND_FULL_NAME FRIEND_FULL_NAME FRIEND_FULL_NAME FRIEND_FULL_NAME | SELECT NAME FRIEND_FULL_NAME	SELECT NAME FRIEND_FULL_NAME | PASS
START | SELECT NAME FRIEND_FULL_NAME	SAY FRIEND_FULL_NAME SAY FRIEND_FULL_NAME FRIEND_FULL_NAME FRIEND_FULL_NAME FRIEND_FULL_NAME | SELECT NAME FRIEND_FULL_NAME
START SAY hi | SAY MY_SCHOOL MY_MAJOR | SAY got FRIEND_FULL_NAME SAY yeppers | SELECT NAME FRIEND_FULL_NAME	SAY hi | SAY FRIEND_FULL_NAME | SELECT NAME FRIEND_FULL_NAME | PASS
START | SAY hi | SAY FRIEND_FULL_NAME | SELECT NAME FRIEND_FULL_NAME	SAY hi | SAY MY_SCHOOL MY_MAJOR | SAY got FRIEND_FULL_NAME SAY yeppers | SELECT NAME FRIEND_FULL_NAME
START SAY hi | SAY FRIEND_FULL_NAME | SELECT NAME FRIEND_FULL_NAME	SAY hi SAY know anybody at MY_COMPANY | SAY yes SAY me too | SELECT NAME FRIEND_FULL_NAME
START | SAY hi SAY know anybody at MY_COMPANY | SAY yes SAY me too | SELECT NAME FRIEND_FULL_NAME	SAY hi | SAY FRIEND_FULL_NAME | SELECT NAME FRIEND_FULL_NAME | PASS
START SAY all friends at MY_COMPANY except one a FRIEND_FULL_NAME at MY_COMPANY | SAY FRIEND_FULL_NAME ya if you got FRIEND_FULL_NAME go for it | SELECT NAME FRIEND_FULL_NAME	SAY MY_SCHOOL MY_MAJOR MY_COMPANY SAY toni brunette | SAY yeah FRIEND_FULL_NAME autocorrect SELECT NAME FRIEND_FULL_NAME | PASS
START | SAY MY_SCHOOL MY_MAJOR MY_COMPANY SAY toni brunette | SAY yeah FRIEND_FULL_NAME autocorrect SELECT NAME FRIEND_FULL_NAME	SAY all friends at MY_COMPANY except one a FRIEND_FULL_NAME at MY_COMPANY | SAY FRIEND_FULL_NAME ya if you got FRIEND_FULL_NAME go for it | SELECT NAME FRIEND_FULL_NAME
START SAY i went to MY_SCHOOL MY_MAJOR and work for MY_COMPANY | SAY sigh | SAY you realize this is more difficult SELECT NAME FRIEND_FULL_NAME	SAY just match names SAY FRIEND_FULL_NAME SAY FRIEND_FULL_NAME SAY FRIEND_FULL_NAME SAY aguea searcy SAY FRIEND_FULL_NAME | SAY FRIEND_FULL_NAME SAY FRIEND_FULL_NAME SAY FRIEND_FULL_NAME SAY FRIEND_FULL_NAME SAY FRIEND_FULL_NAME SAY any matching names | SELECT NAME FRIEND_FULL_NAME
START | SAY just match names SAY FRIEND_FULL_NAME SAY FRIEND_FULL_NAME SAY FRIEND_FULL_NAME SAY aguea searcy SAY FRIEND_FULL_NAME | SAY FRIEND_FULL_NAME SAY FRIEND_FULL_NAME SAY FRIEND_FULL_NAME SAY FRIEND_FULL_NAME SAY FRIEND_FULL_NAME SAY any matching names | SELECT NAME FRIEND_FULL_NAME	SAY i went to MY_SCHOOL MY_MAJOR and work for MY_COMPANY | SAY sigh | SAY you realize this is more difficult SELECT NAME FRIEND_FULL_NAME | PASS
START SAY hi | SAY u of MY_SCHOOL MY_MAJOR and i work for MY_COMPANY | SAY FRIEND_FULL_NAME SELECT NAME FRIEND_FULL_NAME	SAY hi SAY u now FRIEND_FULL_NAME SAY FRIEND_FULL_NAME SAY FRIEND_FULL_NAME | SAY berkeely MY_MAJOR MY_COMPANY | SELECT NAME FRIEND_FULL_NAME
START | SAY hi SAY u now FRIEND_FULL_NAME SAY FRIEND_FULL_NAME SAY FRIEND_FULL_NAME | SAY berkeely MY_MAJOR MY_COMPANY | SELECT NAME FRIEND_FULL_NAME	SAY hi | SAY u of MY_SCHOOL MY_MAJOR and i work for MY_COMPANY | SAY FRIEND_FULL_NAME SELECT NAME FRIEND_FULL_NAME | PASS
START SAY hello | SAY pennsvania MY_MAJOR MY_COMPANY | SELECT NAME FRIEND_FULL_NAME	SAY MY_SCHOOL MY_MAJOR MY_COMPANY | SAY do you know FRIEND_FULL_NAME FRIEND_FULL_NAME or FRIEND_FULL_NAME | SELECT NAME FRIEND_FULL_NAME
START | SAY MY_SCHOOL MY_MAJOR MY_COMPANY | SAY do you know FRIEND_FULL_NAME FRIEND_FULL_NAME or FRIEND_FULL_NAME | SELECT NAME FRIEND_FULL_NAME	SAY hello | SAY pennsvania MY_MAJOR MY_COMPANY | SELECT NAME FRIEND_FULL_NAME | PASS
START SAY ok | SELECT NAME FRIEND_FULL_NAME	SAY alright SELECT NAME FRIEND_FULL_NAME | PASS
START | SAY alright SELECT NAME FRIEND_FULL_NAME	SAY ok | SELECT NAME FRIEND_FULL_NAME
START SAY hi FRIEND_FULL_NAME from MY_SCHOOL | SAY MY_MAJOR and MY_COMPANY SAY i know FRIEND_FULL_NAME and FRIEND_FULL_NAME from MY_SCHOOL | SAY yes FRIEND_FULL_NAME | SELECT NAME FRIEND_FULL_NAME	SAY i go to MY_SCHOOL and majored in MY_MAJOR i work at MY_COMPANY | SAY do you know FRIEND_FULL_NAME | SELECT NAME FRIEND_FULL_NAME | PASS
START | SAY i go to MY_SCHOOL and majored in MY_MAJOR i work at MY_COMPANY | SAY do you know FRIEND_FULL_NAME | SELECT NAME FRIEND_FULL_NAME	SAY hi FRIEND_FULL_NAME from MY_SCHOOL | SAY MY_MAJOR and MY_COMPANY SAY i know FRIEND_FULL_NAME and FRIEND_FULL_NAME from MY_SCHOOL | SAY yes FRIEND_FULL_NAME | SELECT NAME FRIEND_FULL_NAME
START SAY MY_COMPANY SAY hello | SAY MY_COMPANY | SAY running out of time SAY MY_MAJOR | SELECT NAME FRIEND_FULL_NAME	SAY hey | SAY how are you SAY googlr | SELECT NAME FRIEND_FULL_NAME | PASS
START | SAY hey | SAY how are you SAY googlr | SELECT NAME FRIEND_FULL_NAME	SAY MY_COMPANY SAY hello | SAY MY_COMPANY | SAY running out of time SAY MY_MAJOR | SELECT NAME FRIEND_FULL_NAME
START SAY stanfordlinguisticsapple SAY u | SAY FRIEND_FULL_NAME | SELECT NAME FRIEND_FULL_NAME	SAY MY_SCHOOL of MY_SCHOOL MY_MAJOR MY_COMPANY | SAY we can try that SELECT NAME FRIEND_FULL_NAME | PASS
START | SAY MY_SCHOOL of MY_SCHOOL MY_MAJOR MY_COMPANY | SAY we can try that SELECT NAME FRIEND_FULL_NAME	SAY stanfordlinguisticsapple SAY u | SAY FRIEND_FULL_NAME | SELECT NAME FRIEND_FULL_NAME
START SAY upenn MY_MAJOR MY_COMPANY | SAY yup | SELECT NAME FRIEND_FULL_NAME	SAY hi standford liguistics MY_COMPANY SAY you know FRIEND_FULL_NAME | SAY yay | SELECT NAME FRIEND_FULL_NAME
START | SAY hi standford liguistics MY_COMPANY SAY you know FRIEND_FULL_NAME | SAY yay | SELECT NAME FRIEND_FULL_NAME	SAY upenn MY_MAJOR MY_COMPANY | SAY yup | SELECT NAME FRIEND_FULL_NAME | PASS
START SAY MY_SCHOOL MY_MAJOR MY_COMPANY | SAY FRIEND_FULL_NAME or FRIEND_FULL_NAME | SELECT NAME FRIEND_FULL_NAME	SAY MY_SCHOOL MY_MAJOR MY_COMPANY | SAY FRIEND_FULL_NAME | SELECT NAME FRIEND_FULL_NAME
START | SAY MY_SCHOOL MY_MAJOR MY_COMPANY | SAY FRIEND_FULL_NAME | SELECT NAME FRIEND_FULL_NAME	SAY MY_SCHOOL MY_MAJOR MY_COMPANY | SAY FRIEND_FULL_NAME or FRIEND_FULL_NAME | SELECT NAME FRIEND_FULL_NAME | PASS
START SAY 1 MY_COMPANY rest MY_COMPANY | SAY MY_SCHOOL | SAY okay but your friends what did they do SAY 1 works at MY_COMPANY rest work at MY_COMPANY SAY for me | SELECT NAME FRIEND_FULL_NAME	SAY where did you go to school | SAY me MY_SCHOOL MY_MAJOR MY_COMPANY | SAY none of mine are MY_COMPANY i have two at MY_COMPANY SAY FRIEND_FULL_NAME and FRIEND_FULL_NAME | SELECT NAME FRIEND_FULL_NAME
START | SAY where did you go to school | SAY me MY_SCHOOL MY_MAJOR MY_COMPANY | SAY none of mine are MY_COMPANY i have two at MY_COMPANY SAY FRIEND_FULL_NAME and FRIEND_FULL_NAME | SELECT NAME FRIEND_FULL_NAME	SAY 1 MY_COMPANY rest MY_COMPANY | SAY MY_SCHOOL | SAY okay but your friends what did they do SAY 1 works at MY_COMPANY rest work at MY_COMPANY SAY for me | SELECT NAME FRIEND_FULL_NAME | PASS
START SAY hi | SAY MY_COMPANY | SAY lots of MY_SCHOOL SAY FRIEND_FULL_NAME | SELECT NAME FRIEND_FULL_NAME	SAY anyone from u of MY_SCHOOL | SAY all from MY_COMPANY | SAY FRIEND_FULL_NAME FRIEND_FULL_NAME FRIEND_FULL_NAME | SAY FRIEND_FULL_NAME FRIEND_FULL_NAME FRIEND_FULL_NAME SELECT NAME FRIEND_FULL_NAME
START | SAY anyone from u of MY_SCHOOL | SAY all from MY_COMPANY | SAY FRIEND_FULL_NAME FRIEND_FULL_NAME FRIEND_FULL_NAME | SAY FRIEND_FULL_NAME FRIEND_FULL_NAME FRIEND_FULL_NAME SELECT NAME FRIEND_FULL_NAME	SAY hi | SAY MY_COMPANY | SAY lots of MY_SCHOOL SAY FRIEND_FULL_NAME | SELECT NAME FRIEND_FULL_NAME | PASS
START SAY MY_SCHOOL physica and MY_COMPANY are ione SAY i have one MY_COMPANY and all other MY_COMPANY | SELECT NAME FRIEND_FULL_NAME	SAY do you know FRIEND_FULL_NAME locolumbia MY_MAJOR MY_COMPANY SAY FRIEND_FULL_NAME SAY FRIEND_FULL_NAME | SELECT NAME FRIEND_FULL_NAME
START | SAY do you know FRIEND_FULL_NAME locolumbia MY_MAJOR MY_COMPANY SAY FRIEND_FULL_NAME SAY FRIEND_FULL_NAME | SELECT NAME FRIEND_FULL_NAME	SAY MY_SCHOOL physica and MY_COMPANY are ione SAY i have one MY_COMPANY and all other MY_COMPANY | SELECT NAME FRIEND_FULL_NAME | PASS
START SAY hello | SAY i went to university of MY_SCHOOL majored in MY_MAJOR and work at MY_COMPANY SAY FRIEND_FULL_NAME | SELECT NAME FRIEND_FULL_NAME	SAY hi SAY standford MY_MAJOR MY_COMPANY | SAY yes SELECT NAME FRIEND_FULL_NAME | PASS
START | SAY hi SAY standford MY_MAJOR MY_COMPANY | SAY yes SELECT NAME FRIEND_FULL_NAME	SAY hello | SAY i went to university of MY_SCHOOL majored in MY_MAJOR and work at MY_COMPANY SAY FRIEND_FULL_NAME | SELECT NAME FRIEND_FULL_NAME
START SAY any friends at MY_COMPANY | SELECT NAME FRIEND_FULL_NAME	SAY berkley MY_MAJOR MY_COMPANY SAY FRIEND_FULL_NAME | SELECT NAME FRIEND_FULL_NAME
START | SAY berkley MY_MAJOR MY_COMPANY SAY FRIEND_FULL_NAME | SELECT NAME FRIEND_FULL_NAME	SAY any friends at MY_COMPANY | SELECT NAME FRIEND_FULL_NAME | PASS
START SAY hi | SAY FRIEND_FULL_NAME here uoc MY_SCHOOL MY_MAJOR work for MY_COMPANY SAY FRIEND_FULL_NAME SAY and SAY FRIEND_FULL_NAME SAY FRIEND_FULL_NAME and FRIEND_FULL_NAME from MY_SCHOOL | SAY none do you have any from u of MY_SCHOOL MY_SCHOOL | SAY im friends with FRIEND_FULL_NAME too SELECT NAME FRIEND_FULL_NAME	SAY do you have friends from MY_SCHOOL | SAY how about u of MY_SCHOOL | SAY yeah FRIEND_FULL_NAME FRIEND_FULL_NAME and FRIEND_FULL_NAME | SELECT NAME FRIEND_FULL_NAME
START | SAY do you have friends from MY_SCHOOL | SAY how about u of MY_SCHOOL | SAY yeah FRIEND_FULL_NAME FRIEND_FULL_NAME and FRIEND_FULL_NAME | SELECT NAME FRIEND_FULL_NAME	SAY hi | SAY FRIEND_FULL_NAME here uoc MY_SCHOOL MY_MAJOR work for MY_COMPANY SAY FRIEND_FULL_NAME SAY and SAY FRIEND_FULL_NAME SAY FRIEND_FULL_NAME and FRIEND_FULL_NAME from MY_SCHOOL | SAY none do you have any from u of MY_SCHOOL MY_SCHOOL | SAY im friends with FRIEND_FULL_NAME too SELECT NAME FRIEND_FULL_NAME | PASS
START SAY i work at MY_COMPANY do you know anyone there SAY hello | SAY FRIEND_FULL_NAME | SAY i workwhat about at MY_COMPANY | SAY only FRIEND_FULL_NAME SELECT NAME FRIEND_FULL_NAME	SAY what school did you go to | SAY i do not | SAY do you know anyone that works in MY_COMPANY SAY no MY_COMPANY | SELECT NAME FRIEND_FULL_NAME
START | SAY what school did you go to | SAY i do not | SAY do you know anyone that works in MY_COMPANY SAY no MY_COMPANY | SELECT NAME FRIEND_FULL_NAME	SAY i work at MY_COMPANY do you know anyone there SAY hello | SAY FRIEND_FULL_NAME | SAY i workwhat about at MY_COMPANY | SAY only FRIEND_FULL_NAME SELECT NAME FRIEND_FULL_NAME | PASS
START SAY FRIEND_FULL_NAME SAY FRIEND_FULL_NAME SAY FRIEND_FULL_NAME SAY FRIEND_FULL_NAME | SAY FRIEND_FULL_NAME SELECT NAME FRIEND_FULL_NAME	SELECT NAME FRIEND_FULL_NAME | PASS
START | SELECT NAME FRIEND_FULL_NAME	SAY FRIEND_FULL_NAME SAY FRIEND_FULL_NAME SAY FRIEND_FULL_NAME SAY FRIEND_FULL_NAME | SAY FRIEND_FULL_NAME SELECT NAME FRIEND_FULL_NAME
START SAY hi | SAY u of MY_SCHOOL MY_MAJOR and i work for MY_COMPANY | SELECT NAME FRIEND_FULL_NAME	SAY hey | SAY MY_SCHOOL MY_MAJOR MY_COMPANY SAY FRIEND_FULL_NAME | SELECT NAME FRIEND_FULL_NAME
START | SAY hey | SAY MY_SCHOOL MY_MAJOR MY_COMPANY SAY FRIEND_FULL_NAME | SELECT NAME FRIEND_FULL_NAME	SAY hi | SAY u of MY_SCHOOL MY_MAJOR and i work for MY_COMPANY | SELECT NAME FRIEND_FULL_NAME | PASS
START SAY hello | SAY do you have FRIEND_FULL_NAME FRIEND_FULL_NAME FRIEND_FULL_NAME FRIEND_FULL_NAME or FRIEND_FULL_NAME | SAY i have the same nice | SELECT NAME FRIEND_FULL_NAME	SAY hi | SAY know anyone from u of pa SAY FRIEND_FULL_NAME | SELECT NAME FRIEND_FULL_NAME | PASS
START | SAY hi | SAY know anyone from u of pa SAY FRIEND_FULL_NAME | SELECT NAME FRIEND_FULL_NAME	SAY hello | SAY do you have FRIEND_FULL_NAME FRIEND_FULL_NAME FRIEND_FULL_NAME FRIEND_FULL_NAME or FRIEND_FULL_NAME | SAY i have the same nice | SELECT NAME FRIEND_FULL_NAME
START SAY berkeleycomputer siencegoogle SAY u | SAY FRIEND_FULL_NAME FRIEND_FULL_NAME SELECT NAME FRIEND_FULL_NAME	SAY MY_SCHOOL MY_MAJOR MY_COMPANY SAY FRIEND_FULL_NAME | SELECT NAME FRIEND_FULL_NAME
START | SAY MY_SCHOOL MY_MAJOR MY_COMPANY SAY FRIEND_FULL_NAME | SELECT NAME FRIEND_FULL_NAME	SAY berkeleycomputer siencegoogle SAY u | SAY FRIEND_FULL_NAME FRIEND_FULL_NAME SELECT NAME FRIEND_FULL_NAME | PASS
START SAY hello | SAY u of MY_SCHOOL MY_MAJOR MY_COMPANY | SAY nope SAY i got FRIEND_FULL_NAME not FRIEND_FULL_NAME | SELECT NAME FRIEND_FULL_NAME	SAY hi | SAY know a FRIEND_FULL_NAME FRIEND_FULL_NAME SAY FRIEND_FULL_NAME FRIEND_FULL_NAME SAY FRIEND_FULL_NAME | SAY FRIEND_FULL_NAME johmathan FRIEND_FULL_NAME FRIEND_FULL_NAME or FRIEND_FULL_NAME SAY no FRIEND_FULL_NAME here | SELECT NAME FRIEND_FULL_NAME
START | SAY hi | SAY know a FRIEND_FULL_NAME FRIEND_FULL_NAME SAY FRIEND_FULL_NAME FRIEND_FULL_NAME SAY FRIEND_FULL_NAME | SAY FRIEND_FULL_NAME johmathan FRIEND_FULL_NAME FRIEND_FULL_NAME or FRIEND_FULL_NAME SAY no FRIEND_FULL_NAME here | SELECT NAME FRIEND_FULL_NAME	SAY hello | SAY u of MY_SCHOOL MY_MAJOR MY_COMPANY | SAY nope SAY i got FRIEND_FULL_NAME not FRIEND_FULL_NAME | SELECT NAME FRIEND_FULL_NAME | PASS
START SAY hi FRIEND_FULL_NAME from MY_SCHOOL SAY MY_MAJOR and MY_COMPANY | SAY MY_MAJOR | SAY i know FRIEND_FULL_NAME and FRIEND_FULL_NAME SAY FRIEND_FULL_NAME SAY heid SAY do you know FRIEND_FULL_NAME | SELECT NAME FRIEND_FULL_NAME SAY oopa | SELECT NAME FRIEND_FULL_NAME	SAY uc MY_SCHOOL FRIEND_FULL_NAME hi SAY your major | SAY MY_MAJOR here | SAY yes SELECT NAME FRIEND_FULL_NAME | SAY i dont know FRIEND_FULL_NAME | PASS
START | SAY uc MY_SCHOOL FRIEND_FULL_NAME hi SAY your major | SAY MY_MAJOR here | SAY yes SELECT NAME FRIEND_FULL_NAME | SAY i dont know FRIEND_FULL_NAME	SAY hi FRIEND_FULL_NAME from MY_SCHOOL SAY MY_MAJOR and MY_COMPANY | SAY MY_MAJOR | SAY i know FRIEND_FULL_NAME and FRIEND_FULL_NAME SAY FRIEND_FULL_NAME SAY heid SAY do you know FRIEND_FULL_NAME | SELECT NAME FRIEND_FULL_NAME SAY oopa | SELECT NAME FRIEND_FULL_NAME
START SAY hi | SAY berkely MY_MAJOR MY_COMPANY SAY all my friends work for MY_COMPANY | SAY FRIEND_FULL_NAME | SELECT NAME FRIEND_FULL_NAME	SAY hi | SAY MY_SCHOOL MY_MAJOR MY_COMPANY | SELECT NAME FRIEND_FULL_NAME | PASS
START | SAY hi | SAY MY_SCHOOL MY_MAJOR MY_COMPANY | SELECT NAME FRIEND_FULL_NAME	SAY hi | SAY berkely MY_MAJOR MY_COMPANY SAY all my friends work for MY_COMPANY | SAY FRIEND_FULL_NAME | SELECT NAME FRIEND_FULL_NAME
START SAY MY_MAJOR | SELECT NAME FRIEND_FULL_NAME	SAY i went to stanfors majored in MY_MAJOR and work for MY_COMPANY | SELECT NAME FRIEND_FULL_NAME
START | SAY i went to stanfors majored in MY_MAJOR and work for MY_COMPANY | SELECT NAME FRIEND_FULL_NAME	SAY MY_MAJOR | SELECT NAME FRIEND_FULL_NAME | PASS
START SAY greetings SAY FRIEND_FULL_NAME from MY_COMPANY | SAY FRIEND_FULL_NAME from MY_COMPANY | SELECT NAME FRIEND_FULL_NAME	SELECT NAME FRIEND_FULL_NAME | SAY nick | PASS
START | SELECT NAME FRIEND_FULL_NAME | SAY nick	SAY greetings SAY FRIEND_FULL_NAME from MY_COMPANY | SAY FRIEND_FULL_NAME from MY_COMPANY | SELECT NAME FRIEND_FULL_NAME
START SAY MY_SCHOOL MY_MAJOR MY_COMPANY | SAY i have a friend in MY_COMPANY and MY_COMPANY | SAY FRIEND_FULL_NAME | SELECT NAME FRIEND_FULL_NAME	SAY 1 MY_COMPANY 1 MY_COMPANY 1 MY_COMPANY the rest MY_COMPANY | SAY FRIEND_FULL_NAME | SAY FRIEND_FULL_NAME | SELECT NAME FRIEND_FULL_NAME
START | SAY 1 MY_COMPANY 1 MY_COMPANY 1 MY_COMPANY the rest MY_COMPANY | SAY FRIEND_FULL_NAME | SAY FRIEND_FULL_NAME | SELECT NAME FRIEND_FULL_NAME	SAY MY_SCHOOL MY_MAJOR MY_COMPANY | SAY i have a friend in MY_COMPANY and MY_COMPANY | SAY FRIEND_FULL_NAME | SELECT NAME FRIEND_FULL_NAME | PASS
START SAY howdy SAY ucberkley SAY MY_MAJOR MY_MAJOR SAY MY_COMPANY | SAY yep SELECT NAME FRIEND_FULL_NAME	SELECT NAME FRIEND_FULL_NAME | PASS
START | SELECT NAME FRIEND_FULL_NAME	SAY howdy SAY ucberkley SAY MY_MAJOR MY_MAJOR SAY MY_COMPANY | SAY yep SELECT NAME FRIEND_FULL_NAME
START SAY hi | SAY MY_SCHOOL MY_MAJOR fb here | SAY i know ppl at MY_COMPANY fb and MY_COMPANY | SELECT NAME FRIEND_FULL_NAME	SAY hi | SAY MY_SCHOOL MY_MAJOR MY_COMPANY | SELECT NAME FRIEND_FULL_NAME | PASS
START | SAY hi | SAY MY_SCHOOL MY_MAJOR MY_COMPANY | SELECT NAME FRIEND_FULL_NAME	SAY hi | SAY MY_SCHOOL MY_MAJOR fb here | SAY i know ppl at MY_COMPANY fb and MY_COMPANY | SELECT NAME FRIEND_FULL_NAME
START SAY any friends at MY_COMPANY | SAY FRIEND_FULL_NAME | SELECT NAME FRIEND_FULL_NAME	SAY all are at MY_COMPANY | SAY yes | SELECT NAME FRIEND_FULL_NAME
START | SAY all are at MY_COMPANY | SAY yes | SELECT NAME FRIEND_FULL_NAME	SAY any friends at MY_COMPANY | SAY FRIEND_FULL_NAME | SELECT NAME FRIEND_FULL_NAME | PASS
START SAY hi SAY MY_SCHOOL MY_MAJOR MY_COMPANY | SAY do you know FRIEND_FULL_NAME | SAY or FRIEND_FULL_NAME SAY nope | SAY yep SELECT NAME FRIEND_FULL_NAME	SAY my info is MY_SCHOOL MY_MAJOR MY_COMPANY | SAY FRIEND_FULL_NAME | SAY FRIEND_FULL_NAME | SELECT NAME FRIEND_FULL_NAME
START | SAY my info is MY_SCHOOL MY_MAJOR MY_COMPANY | SAY FRIEND_FULL_NAME | SAY FRIEND_FULL_NAME | SELECT NAME FRIEND_FULL_NAME	SAY hi SAY MY_SCHOOL MY_MAJOR MY_COMPANY | SAY do you know FRIEND_FULL_NAME | SAY or FRIEND_FULL_NAME SAY nope | SAY yep SELECT NAME FRIEND_FULL_NAME | PASS
START SAY hi | SAY FRIEND_FULL_NAME | SAY FRIEND_FULL_NAME FRIEND_FULL_NAME FRIEND_FULL_NAME FRIEND_FULL_NAME | SAY FRIEND_FULL_NAME FRIEND_FULL_NAME FRIEND_FULL_NAME FRIEND_FULL_NAME | SELECT NAME FRIEND_FULL_NAME	SAY do you have any friends at fb SAY hey | SAY no i dont know her | SAY i work at MY_COMPANY SAY no | SELECT NAME FRIEND_FULL_NAME | PASS
START | SAY do you have any friends at fb SAY hey | SAY no i dont know her | SAY i work at MY_COMPANY SAY no | SELECT NAME FRIEND_FULL_NAME	SAY hi | SAY FRIEND_FULL_NAME | SAY FRIEND_FULL_NAME FRIEND_FULL_NAME FRIEND_FULL_NAME FRIEND_FULL_NAME | SAY FRIEND_FULL_NAME FRIEND_FULL_NAME FRIEND_FULL_NAME FRIEND_FULL_NAME | SELECT NAME FRIEND_FULL_NAME
START SAY FRIEND_FULL_NAME | SAY or FRIEND_FULL_NAME | SELECT NAME FRIEND_FULL_NAME	SAY FRIEND_FULL_NAME lausaunda FRIEND_FULL_NAME FRIEND_FULL_NAME FRIEND_FULL_NAME | SAY FRIEND_FULL_NAME SAY FRIEND_FULL_NAME SAY FRIEND_FULL_NAME | SELECT NAME FRIEND_FULL_NAME
START | SAY FRIEND_FULL_NAME lausaunda FRIEND_FULL_NAME FRIEND_FULL_NAME FRIEND_FULL_NAME | SAY FRIEND_FULL_NAME SAY FRIEND_FULL_NAME SAY FRIEND_FULL_NAME | SELECT NAME FRIEND_FULL_NAME	SAY FRIEND_FULL_NAME | SAY or FRIEND_FULL_NAME | SELECT NAME FRIEND_FULL_NAME | PASS
START SAY hello | SAY MY_SCHOOL MY_MAJOR and MY_COMPANY here | SAY FRIEND_FULL_NAME | SAY only person i know at MY_COMPANY | SELECT NAME FRIEND_FULL_NAME	SAY hi | SAY know anybody working at MY_COMPANY | SAY yes FRIEND_FULL_NAME | SELECT NAME FRIEND_FULL_NAME | PASS
START | SAY hi | SAY know anybody working at MY_COMPANY | SAY yes FRIEND_FULL_NAME | SELECT NAME FRIEND_FULL_NAME	SAY hello | SAY MY_SCHOOL MY_MAJOR and MY_COMPANY here | SAY FRIEND_FULL_NAME | SAY only person i know at MY_COMPANY | SELECT NAME FRIEND_FULL_NAME
START SAY hi | SAY did you go to MY_SCHOOL | SAY no SAY MY_COMPANY and MY_COMPANY | SAY yes | SELECT NAME FRIEND_FULL_NAME	SAY hi | SAY do you have friends at MY_COMPANY | SAY FRIEND_FULL_NAME | SELECT NAME FRIEND_FULL_NAME | PASS
START | SAY hi | SAY do you have friends at MY_COMPANY | SAY FRIEND_FULL_NAME | SELECT NAME FRIEND_FULL_NAME	SAY hi | SAY did you go to MY_SCHOOL | SAY no SAY MY_COMPANY and MY_COMPANY | SAY yes | SELECT NAME FRIEND_FULL_NAME
START SAY yo SAY went to MY_SCHOOL MY_MAJOR and MY_COMPANY | SAY FRIEND_FULL_NAME SAY no FRIEND_FULL_NAME here | SELECT NAME FRIEND_FULL_NAME	SAY MY_SCHOOL MY_MAJOR MY_COMPANY SAY FRIEND_FULL_NAME | SAY martiza horrell SAY FRIEND_FULL_NAME | SELECT NAME FRIEND_FULL_NAME
START | SAY MY_SCHOOL MY_MAJOR MY_COMPANY SAY FRIEND_FULL_NAME | SAY martiza horrell SAY FRIEND_FULL_NAME | SELECT NAME FRIEND_FULL_NAME	SAY yo SAY went to MY_SCHOOL MY_MAJOR and MY_COMPANY | SAY FRIEND_FULL_NAME SAY no FRIEND_FULL_NAME here | SELECT NAME FRIEND_FULL_NAME | PASS
START SAY any friends at MY_COMPANY SELECT NAME FRIEND_FULL_NAME	SAY 2 MY_COMPANY the rest are MY_COMPANY SELECT NAME FRIEND_FULL_NAME
START | SAY 2 MY_COMPANY the rest are MY_COMPANY SELECT NAME FRIEND_FULL_NAME	SAY any friends at MY_COMPANY SELECT NAME FRIEND_FULL_NAME | PASS
START SAY hi | SAY no SAY MY_COMPANY and MY_COMPANY SAY went to standford | SELECT NAME FRIEND_FULL_NAME	SAY hi SAY do you have friends at MY_COMPANY | SAY FRIEND_FULL_NAME or brigit | SELECT NAME FRIEND_FULL_NAME
START | SAY hi SAY do you have friends at MY_COMPANY | SAY FRIEND_FULL_NAME or brigit | SELECT NAME FRIEND_FULL_NAME	SAY hi | SAY no SAY MY_COMPANY and MY_COMPANY SAY went to standford | SELECT NAME FRIEND_FULL_NAME | PASS
START SAY hi im MY_SCHOOL MY_MAJOR MY_COMPANY SAY you | SAY FRIEND_FULL_NAME | SELECT NAME FRIEND_FULL_NAME	SAY MY_SCHOOL MY_MAJOR MY_COMPANY SAY all mine work at MY_COMPANY | SAY yes SELECT NAME FRIEND_FULL_NAME | PASS
START | SAY MY_SCHOOL MY_MAJOR MY_COMPANY SAY all mine work at MY_COMPANY | SAY yes SELECT NAME FRIEND_FULL_NAME	SAY hi im MY_SCHOOL MY_MAJOR MY_COMPANY SAY you | SAY FRIEND_FULL_NAME | SELECT NAME FRIEND_FULL_NAME
START SAY MY_COMPANY | SAY no | SAY no SAY MY_COMPANY or MY_COMPANY | SAY FRIEND_FULL_NAME SELECT NAME FRIEND_FULL_NAME	SAY do you have any friends at MY_COMPANY | SAY MY_COMPANY | SAY ok so must be MY_COMPANY SAY all mine are MY_COMPANY | SELECT NAME FRIEND_FULL_NAME
START | SAY do you have any friends at MY_COMPANY | SAY MY_COMPANY | SAY ok so must be MY_COMPANY SAY all mine are MY_COMPANY | SELECT NAME FRIEND_FULL_NAME	SAY MY_COMPANY | SAY no | SAY no SAY MY_COMPANY or MY_COMPANY | SAY FRIEND_FULL_NAME SELECT NAME FRIEND_FULL_NAME | PASS
START SAY 3 friends from MY_SCHOOL rest from upenn | SAY where did your friends go to school SAY do you know FRIEND_FULL_NAME | SELECT NAME FRIEND_FULL_NAME	SAY hey im from MY_SCHOOL and majored in MY_MAJOR work at MY_COMPANY | SAY i do | SELECT NAME FRIEND_FULL_NAME
START | SAY hey im from MY_SCHOOL and majored in MY_MAJOR work at MY_COMPANY | SAY i do | SELECT NAME FRIEND_FULL_NAME	SAY 3 friends from MY_SCHOOL rest from upenn | SAY where did your friends go to school SAY do you know FRIEND_FULL_NAME | SELECT NAME FRIEND_FULL_NAME | PASS
START SAY hi | SAY MY_SCHOOL MY_MAJOR MY_COMPANY | SAY no | SAY no | SAY FRIEND_FULL_NAME SELECT NAME FRIEND_FULL_NAME	SAY hi where did you go to school | SAY you know lareete thrailkill | SAY FRIEND_FULL_NAME | SAY FRIEND_FULL_NAME SAY horrell | SELECT NAME FRIEND_FULL_NAME
START | SAY hi where did you go to school | SAY you know lareete thrailkill | SAY FRIEND_FULL_NAME | SAY FRIEND_FULL_NAME SAY horrell | SELECT NAME FRIEND_FULL_NAME	SAY hi | SAY MY_SCHOOL MY_MAJOR MY_COMPANY | SAY no | SAY no | SAY FRIEND_FULL_NAME SELECT NAME FRIEND_FULL_NAME | PASS
START SAY 2 MY_COMPANY rest MY_COMPANY | SAY FRIEND_FULL_NAME or FRIEND_FULL_NAME | SELECT NAME FRIEND_FULL_NAME	SAY all MY_COMPANY | SELECT NAME FRIEND_FULL_NAME | PASS
START | SAY all MY_COMPANY | SELECT NAME FRIEND_FULL_NAME	SAY 2 MY_COMPANY rest MY_COMPANY | SAY FRIEND_FULL_NAME or FRIEND_FULL_NAME | SELECT NAME FRIEND_FULL_NAME
START SAY do you know FRIEND_FULL_NAME | SELECT NAME FRIEND_FULL_NAME | SAY oh i see how this works now do you have a friend majoring in MY_MAJOR | SAY oh i know FRIEND_FULL_NAME | SELECT NAME FRIEND_FULL_NAME	SELECT NAME FRIEND_FULL_NAME | SAY no i dont | SAY just FRIEND_FULL_NAME | SAY and who work to MY_COMPANY | SELECT NAME FRIEND_FULL_NAME
START | SELECT NAME FRIEND_FULL_NAME | SAY no i dont | SAY just FRIEND_FULL_NAME | SAY and who work to MY_COMPANY | SELECT NAME FRIEND_FULL_NAME	SAY do you know FRIEND_FULL_NAME | SELECT NAME FRIEND_FULL_NAME | SAY oh i see how this works now do you have a friend majoring in MY_MAJOR | SAY oh i know FRIEND_FULL_NAME | SELECT NAME FRIEND_FULL_NAME | PASS
START SAY friend at MY_COMPANY | SAY MY_COMPANY | SELECT NAME FRIEND_FULL_NAME	SAY u of c MY_MAJOR MY_COMPANY | SAY MY_COMPANY only | SELECT NAME FRIEND_FULL_NAME
START | SAY u of c MY_MAJOR MY_COMPANY | SAY MY_COMPANY only | SELECT NAME FRIEND_FULL_NAME	SAY friend at MY_COMPANY | SAY MY_COMPANY | SELECT NAME FRIEND_FULL_NAME | PASS
START SAY hello | SAY FRIEND_FULL_NAME FRIEND_FULL_NAME FRIEND_FULL_NAME | SAY FRIEND_FULL_NAME FRIEND_FULL_NAME FRIEND_FULL_NAME SAY university of pa SAY MY_MAJOR and MY_COMPANY | SAY no | SAY no | SAY FRIEND_FULL_NAME SAY no SAY FRIEND_FULL_NAME | SAY FRIEND_FULL_NAME SAY FRIEND_FULL_NAME SAY FRIEND_FULL_NAME SAY FRIEND_FULL_NAME SAY FRIEND_FULL_NAME | SAY anyone SELECT NAME FRIEND_FULL_NAME	SAY hi | SAY if from MY_SCHOOL and im majoring in MY_MAJOR | SAY FRIEND_FULL_NAME | SAY FRIEND_FULL_NAME | SAY FRIEND_FULL_NAME | SAY none of those | SAY FRIEND_FULL_NAME | SELECT NAME FRIEND_FULL_NAME
START | SAY hi | SAY if from MY_SCHOOL and im majoring in MY_MAJOR | SAY FRIEND_FULL_NAME | SAY FRIEND_FULL_NAME | SAY FRIEND_FULL_NAME | SAY none of those | SAY FRIEND_FULL_NAME | SELECT NAME FRIEND_FULL_NAME	SAY hello | SAY FRIEND_FULL_NAME FRIEND_FULL_NAME FRIEND_FULL_NAME | SAY FRIEND_FULL_NAME FRIEND_FULL_NAME FRIEND_FULL_NAME SAY university of pa SAY MY_MAJOR and MY_COMPANY | SAY no | SAY no | SAY FRIEND_FULL_NAME SAY no SAY FRIEND_FULL_NAME | SAY FRIEND_FULL_NAME SAY FRIEND_FULL_NAME SAY FRIEND_FULL_NAME SAY FRIEND_FULL_NAME SAY FRIEND_FULL_NAME | SAY anyone SELECT NAME FRIEND_FULL_NAME | PASS
START SAY hi | SAY MY_SCHOOL MY_MAJOR MY_COMPANY SAY do you know FRIEND_FULL_NAME SAY or nhan hornung | SELECT NAME FRIEND_FULL_NAME	SAY MY_SCHOOL MY_MAJOR MY_COMPANY | SAY nhan SELECT NAME FRIEND_FULL_NAME | PASS
START | SAY MY_SCHOOL MY_MAJOR MY_COMPANY | SAY nhan SELECT NAME FRIEND_FULL_NAME	SAY hi | SAY MY_SCHOOL MY_MAJOR MY_COMPANY SAY do you know FRIEND_FULL_NAME SAY or nhan hornung | SELECT NAME FRIEND_FULL_NAME
START SAY hello | SAY MY_SCHOOL MY_MAJOR | SAY no FRIEND_FULL_NAME FRIEND_FULL_NAME SAY FRIEND_FULL_NAME yes SELECT NAME FRIEND_FULL_NAME	SAY MY_SCHOOL MY_MAJOR MY_MAJOR MY_COMPANY SAY you SAY FRIEND_FULL_NAME FRIEND_FULL_NAME FRIEND_FULL_NAME | SAY FRIEND_FULL_NAME FRIEND_FULL_NAME FRIEND_FULL_NAME on your list SAY FRIEND_FULL_NAME FRIEND_FULL_NAME | SELECT NAME FRIEND_FULL_NAME
START | SAY MY_SCHOOL MY_MAJOR MY_MAJOR MY_COMPANY SAY you SAY FRIEND_FULL_NAME FRIEND_FULL_NAME FRIEND_FULL_NAME | SAY FRIEND_FULL_NAME FRIEND_FULL_NAME FRIEND_FULL_NAME on your list SAY FRIEND_FULL_NAME FRIEND_FULL_NAME | SELECT NAME FRIEND_FULL_NAME	SAY hello | SAY MY_SCHOOL MY_MAJOR | SAY no FRIEND_FULL_NAME FRIEND_FULL_NAME SAY FRIEND_FULL_NAME yes SELECT NAME FRIEND_FULL_NAME | PASS
START SAY hi pannsylavania lunguistics and MY_COMPANY SAY you | SELECT NAME FRIEND_FULL_NAME	SAY MY_SCHOOL MY_MAJOR MY_COMPANY SAY julissas bond | SELECT NAME FRIEND_FULL_NAME
START | SAY MY_SCHOOL MY_MAJOR MY_COMPANY SAY julissas bond | SELECT NAME FRIEND_FULL_NAME	SAY hi pannsylavania lunguistics and MY_COMPANY SAY you | SELECT NAME FRIEND_FULL_NAME | PASS
START SAY MY_COMPANY only | SAY who do you know at MY_COMPANY | SELECT NAME FRIEND_FULL_NAME	SAY ucal MY_SCHOOL MY_MAJOR MY_COMPANY SAY you | SAY FRIEND_FULL_NAME FRIEND_FULL_NAME enmmanuel | SAY FRIEND_FULL_NAME SELECT NAME FRIEND_FULL_NAME
START | SAY ucal MY_SCHOOL MY_MAJOR MY_COMPANY SAY you | SAY FRIEND_FULL_NAME FRIEND_FULL_NAME enmmanuel | SAY FRIEND_FULL_NAME SELECT NAME FRIEND_FULL_NAME	SAY MY_COMPANY only | SAY who do you know at MY_COMPANY | SELECT NAME FRIEND_FULL_NAME | PASS
START SAY my info is MY_SCHOOL MY_MAJOR MY_COMPANY you | SELECT NAME FRIEND_FULL_NAME	SELECT NAME FRIEND_FULL_NAME | PASS
START | SELECT NAME FRIEND_FULL_NAME	SAY my info is MY_SCHOOL MY_MAJOR MY_COMPANY you | SELECT NAME FRIEND_FULL_NAME
START SAY hi | SAY nope | SAY sttill mope SAY FRIEND_FULL_NAME SELECT NAME FRIEND_FULL_NAME	SAY any of your friends named FRIEND_FULL_NAME FRIEND_FULL_NAME FRIEND_FULL_NAME SAY FRIEND_FULL_NAME FRIEND_FULL_NAME | SAY FRIEND_FULL_NAME FRIEND_FULL_NAME SAY FRIEND_FULL_NAME FRIEND_FULL_NAME FRIEND_FULL_NAME | SELECT NAME FRIEND_FULL_NAME
START | SAY any of your friends named FRIEND_FULL_NAME FRIEND_FULL_NAME FRIEND_FULL_NAME SAY FRIEND_FULL_NAME FRIEND_FULL_NAME | SAY FRIEND_FULL_NAME FRIEND_FULL_NAME SAY FRIEND_FULL_NAME FRIEND_FULL_NAME FRIEND_FULL_NAME | SELECT NAME FRIEND_FULL_NAME	SAY hi | SAY nope | SAY sttill mope SAY FRIEND_FULL_NAME SELECT NAME FRIEND_FULL_NAME | PASS
START SAY i went to MY_SCHOOL for MY_MAJOR and i work for MY_COMPANY SAY i went to MY_SCHOOL for MY_MAJOR and work at MY_COMPANY | SAY FRIEND_FULL_NAME SAY FRIEND_FULL_NAME | SAY FRIEND_FULL_NAME | SELECT NAME FRIEND_FULL_NAME	SAY i went to MY_SCHOOL and work for MY_COMPANY | SAY no SAY no | SAY FRIEND_FULL_NAME | SELECT NAME FRIEND_FULL_NAME
START | SAY i went to MY_SCHOOL and work for MY_COMPANY | SAY no SAY no | SAY FRIEND_FULL_NAME | SELECT NAME FRIEND_FULL_NAME	SAY i went to MY_SCHOOL for MY_MAJOR and i work for MY_COMPANY SAY i went to MY_SCHOOL for MY_MAJOR and work at MY_COMPANY | SAY FRIEND_FULL_NAME SAY FRIEND_FULL_NAME | SAY FRIEND_FULL_NAME | SELECT NAME FRIEND_FULL_NAME | PASS
START SAY MY_COMPANY or MY_COMPANY | SAY no facebok only MY_COMPANY and one MY_COMPANY SAY or one MY_COMPANY and the rest MY_COMPANY | SELECT NAME FRIEND_FULL_NAME	SAY hey SAY MY_COMPANY SAY MY_SCHOOL MY_MAJOR MY_COMPANY SAY you | SAY FRIEND_FULL_NAME or FRIEND_FULL_NAME | SELECT NAME FRIEND_FULL_NAME
START | SAY hey SAY MY_COMPANY SAY MY_SCHOOL MY_MAJOR MY_COMPANY SAY you | SAY FRIEND_FULL_NAME or FRIEND_FULL_NAME | SELECT NAME FRIEND_FULL_NAME	SAY MY_COMPANY or MY_COMPANY | SAY no facebok only MY_COMPANY and one MY_COMPANY SAY or one MY_COMPANY and the rest MY_COMPANY | SELECT NAME FRIEND_FULL_NAME | PASS
START SAY hey | SELECT NAME FRIEND_FULL_NAME	SAY MY_COMPANY | SELECT NAME FRIEND_FULL_NAME
START | SAY MY_COMPANY | SELECT NAME FRIEND_FULL_NAME	SAY hey | SELECT NAME FRIEND_FULL_NAME | PASS
START SAY hi | SAY im from colombia in MY_MAJOR and at MY_COMPANY | SAY FRIEND_FULL_NAME or FRIEND_FULL_NAME | SELECT NAME FRIEND_FULL_NAME	SAY hello | SAY all of my friends work for MY_COMPANY | SAY im friends with FRIEND_FULL_NAME as well | SELECT NAME FRIEND_FULL_NAME
START | SAY hello | SAY all of my friends work for MY_COMPANY | SAY im friends with FRIEND_FULL_NAME as well | SELECT NAME FRIEND_FULL_NAME	SAY hi | SAY im from colombia in MY_MAJOR and at MY_COMPANY | SAY FRIEND_FULL_NAME or FRIEND_FULL_NAME | SELECT NAME FRIEND_FULL_NAME | PASS
START SAY hey there SAY MY_SCHOOL MY_MAJOR MY_COMPANY | SAY school major company | SELECT NAME FRIEND_FULL_NAME	SAY hello | SAY MY_SCHOOL ecocomics MY_COMPANY SAY yes | SELECT NAME FRIEND_FULL_NAME
START | SAY hello | SAY MY_SCHOOL ecocomics MY_COMPANY SAY yes | SELECT NAME FRIEND_FULL_NAME	SAY hey there SAY MY_SCHOOL MY_MAJOR MY_COMPANY | SAY school major company | SELECT NAME FRIEND_FULL_NAME | PASS
START SAY hi | SAY MY_SCHOOL MY_MAJOR MY_COMPANY | SAY i know FRIEND_FULL_NAME | SELECT NAME FRIEND_FULL_NAME	SAY hi SAY MY_SCHOOL of MY_SCHOOL MY_MAJOR MY_COMPANY SAY how about yourself | SAY do you know FRIEND_FULL_NAME SAY or FRIEND_FULL_NAME | SELECT NAME FRIEND_FULL_NAME | PASS
START | SAY hi SAY MY_SCHOOL of MY_SCHOOL MY_MAJOR MY_COMPANY SAY how about yourself | SAY do you know FRIEND_FULL_NAME SAY or FRIEND_FULL_NAME | SELECT NAME FRIEND_FULL_NAME	SAY hi | SAY MY_SCHOOL MY_MAJOR MY_COMPANY | SAY i know FRIEND_FULL_NAME | SELECT NAME FRIEND_FULL_NAME
START SAY MY_SCHOOL MY_MAJOR MY_MAJOR MY_COMPANY | SAY no SAY do you know FRIEND_FULL_NAME | SELECT NAME FRIEND_FULL_NAME	SAY MY_SCHOOL MY_MAJOR MY_COMPANY SAY FRIEND_FULL_NAME | SAY yes SELECT NAME FRIEND_FULL_NAME | PASS
START | SAY MY_SCHOOL MY_MAJOR MY_COMPANY SAY FRIEND_FULL_NAME | SAY yes SELECT NAME FRIEND_FULL_NAME	SAY MY_SCHOOL MY_MAJOR MY_MAJOR MY_COMPANY | SAY no SAY do you know FRIEND_FULL_NAME | SELECT NAME FRIEND_FULL_NAME
START SAY hello | SAY my friends work at MY_COMPANY or MY_COMPANY SAY how about your friends | SAY y SELECT NAME FRIEND_FULL_NAME	SAY hi i work at MY_COMPANY and went to u of MY_SCHOOL for MY_MAJOR | SAY FRIEND_FULL_NAME | SELECT NAME FRIEND_FULL_NAME
START | SAY hi i work at MY_COMPANY and went to u of MY_SCHOOL for MY_MAJOR | SAY FRIEND_FULL_NAME | SELECT NAME FRIEND_FULL_NAME	SAY hello | SAY my friends work at MY_COMPANY or MY_COMPANY SAY how about your friends | SAY y SELECT NAME FRIEND_FULL_NAME | PASS
START SAY hi | SAY none from MY_COMPANY here | SAY FRIEND_FULL_NAME SELECT NAME FRIEND_FULL_NAME	SAY MY_COMPANY | SAY FRIEND_FULL_NAME | SELECT NAME FRIEND_FULL_NAME
START | SAY MY_COMPANY | SAY FRIEND_FULL_NAME | SELECT NAME FRIEND_FULL_NAME	SAY hi | SAY none from MY_COMPANY here | SAY FRIEND_FULL_NAME SELECT NAME FRIEND_FULL_NAME | PASS
START SAY hello | SAY went to MY_SCHOOL MY_MAJOR MY_COMPANY | SAY FRIEND_FULL_NAME | SELECT NAME FRIEND_FULL_NAME	SAY hi | SAY i work at MY_COMPANY and went to MY_SCHOOL for ecomics | SAY FRIEND_FULL_NAME SELECT NAME FRIEND_FULL_NAME | PASS
START | SAY hi | SAY i work at MY_COMPANY and went to MY_SCHOOL for ecomics | SAY FRIEND_FULL_NAME SELECT NAME FRIEND_FULL_NAME	SAY hello | SAY went to MY_SCHOOL MY_MAJOR MY_COMPANY | SAY FRIEND_FULL_NAME | SELECT NAME FRIEND_FULL_NAME
START SAY u of p MY_MAJOR MY_COMPANY | SAY no FRIEND_FULL_NAME | SELECT NAME FRIEND_FULL_NAME	SELECT NAME FRIEND_FULL_NAME | SELECT NAME FRIEND_FULL_NAME | PASS
START | SELECT NAME FRIEND_FULL_NAME | SELECT NAME FRIEND_FULL_NAME	SAY u of p MY_MAJOR MY_COMPANY | SAY no FRIEND_FULL_NAME | SELECT NAME FRIEND_FULL_NAME
START SAY hello | SAY no | SAY FRIEND_FULL_NAME SELECT NAME FRIEND_FULL_NAME	SAY FRIEND_FULL_NAME FRIEND_FULL_NAME FRIEND_FULL_NAME | SAY FRIEND_FULL_NAME FRIEND_FULL_NAME FRIEND_FULL_NAME FRIEND_FULL_NAME | SELECT NAME FRIEND_FULL_NAME
START | SAY FRIEND_FULL_NAME FRIEND_FULL_NAME FRIEND_FULL_NAME | SAY FRIEND_FULL_NAME FRIEND_FULL_NAME FRIEND_FULL_NAME FRIEND_FULL_NAME | SELECT NAME FRIEND_FULL_NAME	SAY hello | SAY no | SAY FRIEND_FULL_NAME SELECT NAME FRIEND_FULL_NAME | PASS
START SAY friend who works for MY_COMPANY | SAY FRIEND_FULL_NAME | SELECT NAME FRIEND_FULL_NAME	SAY no one SAY all for MY_COMPANY | SELECT NAME FRIEND_FULL_NAME | PASS
START | SAY no one SAY all for MY_COMPANY | SELECT NAME FRIEND_FULL_NAME	SAY friend who works for MY_COMPANY | SAY FRIEND_FULL_NAME | SELECT NAME FRIEND_FULL_NAME
START SAY hey there | SAY MY_SCHOOL MY_MAJOR MY_COMPANY SAY you | SELECT NAME FRIEND_FULL_NAME | SAY who is the one at MY_COMPANY SAY mine are all MY_COMPANY	SAY hi | SAY MY_SCHOOL MY_MAJOR and MY_COMPANY | SAY i have one frined at MY_COMPANY and one MY_COMPANY | SELECT NAME FRIEND_FULL_NAME
START | SAY hi | SAY MY_SCHOOL MY_MAJOR and MY_COMPANY | SAY i have one frined at MY_COMPANY and one MY_COMPANY | SELECT NAME FRIEND_FULL_NAME	SAY hey there | SAY MY_SCHOOL MY_MAJOR MY_COMPANY SAY you | SELECT NAME FRIEND_FULL_NAME | SAY who is the one at MY_COMPANY SAY mine are all MY_COMPANY | PASS
START SELECT NAME FRIEND_FULL_NAME	SELECT NAME FRIEND_FULL_NAME
START | SELECT NAME FRIEND_FULL_NAME	SELECT NAME FRIEND_FULL_NAME | PASS
START SAY MY_SCHOOL MY_MAJOR MY_COMPANY | SAY FRIEND_FULL_NAME | SELECT NAME FRIEND_FULL_NAME	SAY FRIEND_FULL_NAME MY_SCHOOL major MY_MAJOR work for MY_COMPANY | SAY FRIEND_FULL_NAME | SELECT NAME FRIEND_FULL_NAME
START | SAY FRIEND_FULL_NAME MY_SCHOOL major MY_MAJOR work for MY_COMPANY | SAY FRIEND_FULL_NAME | SELECT NAME FRIEND_FULL_NAME	SAY MY_SCHOOL MY_MAJOR MY_COMPANY | SAY FRIEND_FULL_NAME | SELECT NAME FRIEND_FULL_NAME | PASS
